                                     MEDIA INFO


CHRISTMAS SONGS

MPEG1 Layer3 * 320Kbps CBR * 2Ch * 44,1KHz

Songlist:
 
http://www.hotimg.com/direct/d36SVv5.jpg


Incl:

Abba - Happy New Year
Band Aid - Do They Know It's Christmas
Beyonce - Ave Maria
Bing Crosby+David Bowie - Peace On Earth/Little Drummer Boy
Bon Jovi - I Wish Everyday Could Be Like Christmas
Britney Spears - My Only Wish This Year
Bryan Adams - Christmas Time
Celine Dion - I met An Angel
Chris Brown - This Christmas
Christina Aguilera - The Christmas Song
David Essex - A Winter's Tale
Elvis ft.Carrie Underwood - I'll Be Home For Christmas
Elvis ft.Martina McBride - Blue Christmas
Faith Hill - Where Are You Christmas
Jannes - Deze Kerst Ben Jij Bij Mij
John Lennon - Happy Xmas(War Is Over)
Justin Bieber ft.The Band Perry - Home This Christmas
Kelly Clarkson - I'll Be Home For Christmas
Lady Antebellum - Baby It's Cold Outside
Lady GaGa ft.Space Cowboy - Christmas Tree
Marco Borsato - Kerstmis
Matthew West - The Heart Of Christmas
Michael Buble ft.Shania Twain - White Christmas
Michael Buble - Christmas
Milou - Christmas Morning
Queen - Thank God It's Christmas
Rascal Flatts - Jingle Bell Rock
Shakin Stevens - Merry Christmas Everyone
Taylor Swift - Christmases When You Were Mine
Train - Shake Up Christmas
etc...

Got this from several mp3 sites
 
http://thepiratebay.org/user/MeRaDil

 