History Book Collection (EPUB/MOBI)


Brought to you from DigitalLibrarian:
Here are my collection of history book with historical autobiographies and biographies dealing with war. I probably could have spent a little more time organizing by time period but it's a library worth exploring. Enjoy!




Autobiography - Histroical Figures

1861: The Civil War Awakening - Adam Goodheart
A Strange Stirring: The Feminine Mystique and American Women at the Dawn of the 1960s - Stephanie Coontz
A. Lincoln: A Biography - Ronald C White, Jr.
American Lion - Jon Meacham
An Autobiography - M. K. Gandhi, Mahadev Desai
Ben and Me: From Temperance to Humility - Cameron Gunn
Beyond Band of Brothers - Richard D. Winters, Cole Christian Kingseed
Bismarck: A Life - Jonathan Steinberg
Bloody Crimes: The Chase for Jefferson Davis and the Death Pageant for Lincoln's Corpse - James L. Swanson
Bold Spirit - Linda Hunt
Catherine the Great - Simon Dixon
Chasing the Flame: Sergio Vieira De Mello and the Fight to Save the World - Samantha Power
China Witness - Xinran
Churchill - Paul Johnson
Cleopatra: A Life - Stacy Schiff
Colonel Roosevelt - Edmund Morris
Desert Queen - Janet Wallach
Fab: An Intimate Life of Paul McCartney - Howard Sounes
FDR - Jean Edward Smith
First Family: Abigail and John Adams - Joseph J. Ellis
Gabriel GarcÃŒ_a MÃŒÃrquez: A Life - Gerald Martin
Genghis Khan and the Making of the Modern World - Jack Weatherford
Goodbye, Darkness: A Memoir of the Pacific War - William Manchester
Great Soul: Mahatma Gandhi and His Struggle With India - Joseph Lelyveld
Henry Clay: The Essential American - David S. Heidler, Jeanne T. Heidler
Hetty: The Genius and Madness of America's First Female Tycoon - Charles Slack
Hitler - Ian Kershaw
Hitler's Panzers: The Lightning Attacks That Revolutionized Warfare - Dennis Showalter
In the Valley of the Kings: Howard Carter and the Mystery of King Tutankhamun's Tomb - Daniel Meyerson
James Madison - Richard Brookhiser
John Adams - David Mccullough
Lightning Man: The Accursed Life of Samuel F. B. Morse - Kenneth Silverman
Love and Louis XIV: The Women in the Life of the Sun King - Antonia Fraser
Lucia - Andrea Di Robilant
Lucrezia Borgia: Life, Love and Death in Renaissance Italy - Sarah Bradford
Malcolm X: A Life of Reinvention - Manning Marable
Marco Polo - Laurence Bergreen
Mary Tudor - Anna Whitelock
Master of the Senate: The Years of Lyndon Johnson - Robert A. Caro
Personal Memoirs of Ulysses S. Grant - Ulysses S. Grant, Mr. Rod Paschall
Pope Joan: A Novel - Donna Woolfolk Cross
Samuel Pepys - Claire Tomalin
Shakespeare - Peter Ackroyd
The Authentic Life of Billy the Kid - Pat F. Garrett, Fredrick Nolan
The Fabulous History of the Dismal Swamp Company: A Story of George Washington's Times - Charles Royster
The First American: The Life and Times of Benjamin Franklin - H.W. Brands
The First Tycoon: The Epic Life of Cornelius Vanderbilt - T. J. Stiles
The Great Bridge: The Epic Story of the Building of the Brooklyn Bridge - David Mccullough
The King's Speech - Mark Logue, Peter Conradi
The Lady in the Tower: The Fall of Anne Boleyn - Alison Weir
The Last Manchu - Henry Pu Yi, Paul Kramer
The Lodger Shakespeare: His Life on Silver Street - Charles Nicholl
The Man Who Loved China - Simon Winchester
The Quiet World: Saving Alaska's Wilderness Kingdom, 1879-1960 - Douglas Brinkley
The Rise of Theodore Roosevelt - Edmund Morris
The Wilderness Warrior - Douglas Brinkley
The Worst Journey in the World - Apsley Cherry-Garrard
Theodore Rex - Edmund Morris
To Hell on a Fast Horse: Billy the Kid, Pat Garrett, and the Epic Chase to Justice in the Old West - Mark Lee Gardner
Trotsky - Volkogonov, Dmitri
Truman - David Mccullough
Ulysses S. Grant - Michael Korda
Unbroken: A World War II Story of Survival, Resilience, and Redemption - Laura Hillenbrand
Wedlock - Wendy Moore
White Heat: The Friendship of Emily Dickinson and Thomas Wentworth Higginson - Brenda Wineapple
Woodrow Wilson: A Biography - John Milton Cooper
You Can't Be Neutral on a Moving Train: A Personal History of Our Times - Howard Zinn

General History Books

The Penguin Guide to the United States Constitution: A Fully Annotated Declaration of Independence, U.S. Constitution and Amendments,and Selections From the Federalist Papers Richard Beeman
1066 - Andrew Bridgeford
1776 - David Mccullough
1968 - Mark Kurlansky
"Live From Cape Canaveral" - Jay Barbree
1001 People Who Made America - Alan Axelrod
1491: New Revelations of the Americas Before Columbus - Charles C. Mann
1492: The Year Our World Began - Felipe Fernandez-Armesto
1493: Uncovering the New World Columbus Created - Charles C. Mann
1915: The Death of Innocence - Lyn Macdonald
97 Orchard: An Edible History of Five Immigrant Families in One New York Tenement - Jane Ziegelman
A Brave Vessel: The True Tale of the Castaways Who Rescued Jamestown and Inspired Shakespeare's the Tempest - Hobson Woodward
A Chosen Few - Mark Kurlansky
A Commonwealth of Thieves: The Improbable Birth of Australia - Thomas Keneally
A Distant Mirror: The Calamitous 14th Century - Barbara W. Tuchman
A Fiery Peace in a Cold War: Bernard Schriever and the Ultimate Weapon - Neil Sheehan
A History of Scotland - Neil Oliver
A History of Zionism - Walter Laqueur
A People's History of the United States: 1492-Present - Howard Zinn
A Sacred Union of Citizens: George Washington's Farewell Address and the American Character - Matthew Spalding, Patrick J. Garrity, Daniel J. Boorstin
A Secret Gift - Ted Gup
A World Lit Only by Fire: The Medieval Mind and the Renaissance : Portrait of an Age - William Manchester
Absolute Monarchs: A History of the Papacy - John Julius Norwich
Adventures of a Sea Hunter: In Search of Famous Shipwrecks - James P. Delgado, Clive Cussler
Affection and Trust - Harry S. Truman, Dean Acheson, Ray Geselbracht, David C. Acheson, David Mccullough
After the Prophet: The Epic Story of the Shia-Sunni Split in Islam - Lesley Hazleton
Agincourt: Henry v and the Battle That Made England - Juliet R. V. Barker
Albion - Peter Ackroyd
Albion's Seed - David Hackett Fischer
American Colossus: The Triumph of Capitalism, 1865-1900 - H. W. Brands
American Passage: The History of Ellis Island - Vincent J. Cannato
American-Made: The Enduring Legacy of the WPA : When FDR Put the Nation to Work - Nick Taylor
Americans in Paris: Life and Death Under Nazi Occupation - Charles Glass
Ancient Iraq - Georges Roux
Anything Goes: A Biography of the Roaring Twenties - Lucy Moore
Appetite for America - Stephen Fried
Bachelor Girl: The Secret History of Single Women in the Twentieth Century - Betsy Israel
Batavia's Graveyard - Mike Dash
Been in the Storm So Long: The Aftermath of Slavery - Leon F. Litwack
Behind the Berlin Wall - Patrick Major
Beyond the Hundredth Meridian: John Wesley Powell and the Second Opening of the West - Wallace Earle Stegner
Blood and Thunder - Hampton Sides
Carthage Must Be Destroyed: The Rise and Fall of an Ancient Civilization - Richard Miles
Challenge for the Pacific: Guadalcanal: The Turning Point of the War - Robert Leckie
Citizens: A Chronicle of the French Revolution - Simon Schama
Civilization: The West and the Rest - Niall Ferguson
Close to Shore - Michael Capuzzo, Mike Capuzzo
Collapse: How Societies Choose to Fail or Succeed - Jared Diamond
Columbus: The Four Voyages - Laurence Bergreen
Commodore Perry in the Land of the Shogun - Rhoda Blumberg
Company: A Short History of a Revolutionary Idea - John Micklethwait, Adrian Wooldridge
Crimes of Paris: A True Story of Murder, Theft, and Detection - Dorothy Hoobler, Thomas Hoobler
Dancing in the Glory of Monsters: The Collapse of the Congo and the Great War of Africa - Jason Stearns
Dark Tide: The Great Boston Molasses Flood of 1919 - Stephen Puleo
Dark Water: Flood and Redemption in the City of Masterpieces - Robert Clark
David Crockett: The Lion of the West - Michael Wallis
Deadliest Sea - Kalee Thompson
Death in the Haymarket: A Story of Chicago, the First Labor Movement, and the Bombing That Divided Gilded Age America - James R. Green
Destiny Disrupted - Tamim Ansary
Destiny of the Republic - Candice Millard
Doubt: A History: The Great Doubters and Their Legacy of Innovation From Socrates and Jesus to Thomas Jefferson and Emily Dickinson - Jennifer Hecht
Elizabeth Street - Laurie Fabiano
Empire Lost - Andrew Stewart
Empire of Blue Water - Stephan Talty
Empires of the Atlantic World: Britain and Spain in America, 1492-1830 - John Huxtable Elliott
Enlightenment - Roy Porter
Europe: A History - Norman Davies
Europe's Tragedy: A New History of the Thirty Years War - Peter H. Wilson
Evicted From Eternity: The Restructuring of Modern Rome - Michael Herzfeld
Final Voyage: A Story of Arctic Disaster and One Fateful Whaling Season - Peter Nichols
First Salute - Barbara Wertheim Tuchman
Forgotten Wars: Freedom and Revolution in Southeast Asia - Christopher Bayly, Tim Harper
Founding Brothers: The Revolutionary Generation - Joseph J. Ellis
Freedom Summer - Bruce W. Watson
Freethinkers: A History of American Secularism - Susan Jacoby
Fromms: How Julius Fromm's Condom Empire Fell to the Nazis - GÃŒÂ¦tz Aly, Michael Sontheimer, Shelley Frisch
Frost/Nixon - David Frost
George, Nicholas and Wilhelm: Three Royal Cousins and the Road to World War I - Miranda Carter
God's Fury, England's Fire: A New History of the English Civil Wars - Michael J. Braddick
Godâ€°Ã›Âªs Philosophers: How the Medieval World Laid the Foundations of Modern Science - James Hannam
Going Dutch: How England Plundered Holland's Glory - Lisa Jardine
Gotham: A History of New York City to 1898 - Edwin G. Burrows, Mike Wallace
Great Tales From English History - Robert Lacey
Great Tales From English History, Book 2 - Robert Lacey
Gulag: A History - Anne Applebaum
Guns, Germs, and Steel: The Fates of Human Societies - Jared M. Diamond
Higher: A Historic Race to the Sky and the Making of a City - Neal Bascomb
Hot Time in the Old Town - Edward Kohn
How the Scots Invented the Modern World: The True Story of How Western Europe's Poorest Nation Created Our World and Everything in It - Arthur Herman
How the States Got Their Shapes Too: The People Behind the Borderlines - Mark Stein
In the Garden of Beasts: Love, Terror, and an American Family in Hitler's Berlin - Erik Larson
In the Heart of the Sea: The Tragedy of the Whaleship Essex - Nathaniel Philbrick
In the President's Secret Service - Ronald Kessler
Iron Kingdom: The Rise and Downfall of Prussia, 1600-1947 - Christopher M. Clark
Jefferson's War: America's First War on Terror 1801-1805 - Joseph Wheelan
Jerusalem: The Biography - Simon Sebag Montefiore
Killer Colt: Murder, Disgrace, and the Making of an American Legend - Harold Schechter
Killing Lincoln - Bill O'Reilly, Martin Dugard
Last Call: The Rise and Fall of Prohibition - Daniel Okrent
Legacy of Ashes: The History of the CIA - Tim Weiner
Lies My Teacher Told Me About Christopher Columbus: What Your History Books Got Wrong - James W. Loewen
Life in a Medieval City - Joseph Gies, Frances Gies
Life in a Medieval Village - Frances Gies, Joseph Gies
Living Our Language: Ojibwe Tales & Oral Histories - Anton Treuer
London: A Biography - Peter Ackroyd
Lords of the Sea: The Epic Story of the Athenian Navy and the Birth of Democracy - John R. Hale
Lost and Found in Russia: Encounters in the Deep Heartland - Susan Richards
Lost to the West: The Forgotten Byzantine Empire That Rescued Western Civilization - Lars Brownworth
Making Haste From Babylon - Nick Bunker
Mao's Great Famine: The History of China's Most Devastating Catastrophe, 1958-1962 - Frank Dikotter
Master of the Crossroads - Madison Smartt Bell
Mayflower: A Story of Courage, Community, and War - Nathaniel Philbrick
Millionaire: The Philanderer, Gambler, and Duelist Who Invented Modern Finance - Janet Gleeson
Nazi Germany and the Jews: The Years of Persecution, 1933-1939 - Saul FriedlÃŒ_nder
Neptune's Inferno: The U.S. Navy at Guadalcanal - James D. Hornfischer
Newton and the Counterfeiter: The Unknown Detective Career of the World's Greatest Scientist - Thomas Levenson
Nothing Like It in the World: The Men Who Built the Transcontinental Railroad, 1863-1869 - Stephen E. Ambrose
Occult America: The Secret History of How Mysticism Shaped Our Nation - Mitch Horowitz
One Minute to Midnight: Kennedy, Khrushchev, and Castro on the Brink of Nuclear War - Michael Dobbs
Our Last Best Chance: The Pursuit of Peace in a Time of Peril - King Abdullah II, King Abdullah
Pakistan: A Hard Country - Anatol Lieven
Panama Fever: The Epic Story of One of the Greatest Human Achievements of All Time--The Building of the Panama Canal - Matthew Parker
Paris After the Liberation: 1944 - 1949 - Antony Beevor, Artemis Cooper
Pirate Hunter of the Caribbean - David Cordingly
Pirates of Barbary: Corsairs, Conquests and Captivity in the Seventeenth-Century Mediterranean - Adrian Tinniswood
Pox: An American History - Michael Willrich
Practicing History: Selected Essays - Barbara W. Tuchman
Proud Tower - Barbara W. Tuchman
Red Capitalism: The Fragile Financial Foundation of China's Extraordinary Rise - Carl E. Walter, Fraser J. T. Howie
Resurrecting Pompeii - Estelle Lazer
Retribution: The Battle for Japan, 1944-45 - Max Hastings
Rifles - Mark Urban
Rising Tide: The Great Mississippi Flood of 1927 and How It Changed America - John M. Barry
Rival Rails: The Race to Build America's Greatest Transcontinental Railroad - Walter R. Borneman
Rome - Robert Hughes
Rome's Gothic Wars: From the Third Century to Alaric - Michael Kulikowski
Rubicon - Tom Holland
Russia Against Napoleon: The True Story of the Campaigns of War and Peace - Dominic Lieven
Sea of Glory: America's Voyage of Discovery, the U.s. Exploring Expedition, 1838-1842 - Nathaniel Philbrick
Ship of Ghosts - James D. Hornfischer
Slavery by Another Name: The Re-Enslavement of Black Americans From the Civil War to World War II - Douglas A. Blackmon
Song of Slaves in the Desert - Alan Cheuse
Spycraft - Melton, Robert Wallace, Schlesinger
Stupid History: Tales of Stupidity, Strangeness, and Mythconceptions Throughout the Ages - Leland Gregory
Sudden Sea: The Great Hurricane of 1938 - R.A. Scotti
Team of Rivals: The Political Genius of Abraham Lincoln - Doris Kearns Goodwin
Templars: History and Myth: From Solomon's Temple to the Freemasons - Michael Haag
The Age of Revolution - Winston Spencer Churchill, Jeffrey Webb
The Americans: The Democratic Experience - Daniel Boorstin
The Aquariums of Pyongyang: Ten Years in the North Korean Gulag - Chol-hwan Kang, Pierre Rigoulot
The Ascent of Money: A Financial History of the World - Niall Ferguson
The Atlantic and Its Enemies: A History of the Cold War - Norman Stone
The Balfour Declaration - Jonathan Schneer
The Basque History of the World - Mark Kurlansky
The Battle for Christmas - Stephen Nissenbaum
The Battle for Gotham: New York in the Shadow of Robert Moses and Jane Jacobs - Roberta Brandes Gratz
The Birth of Britain - Winston Spencer Churchill, Michael Frassetto
The Book of the Dead - John Mitchinson, John Lloyd
The Chinese in America - Iris Chang
The Circus Fire - Stewart O'Nan
The Classical World: An Epic History From Homer to Hadrian - Robin Lane Fox
The Closing of the Western Mind: The Rise of Faith and the Fall of Reason - Charles Freeman
The Coming of the Third Reich - Richard J. Evans
The Complete Histories of Polybius - Polybius
The Complete Idiot's Guide to World History - Timothy C. Hall
The Day We Lost the H-Bomb: Cold War, Hot Nukes, and the Worst Nuclear Weapons Disaster in History - Barbara Moran
The Dead Hand: The Untold Story of the Cold War Arms Race and Its Dangerous Legacy - David Emanuel Hoffman
The Decline and Fall of the British Empire, 1781-1997 - Piers Brendon
The Devil's Gentleman: Privilege, Poison, and the Trial That Ushered in the Twentieth Century - Harold Schechter
The Devil's Playground: A Century of Pleasure and Profit in Times Square - James Traub
The Empire Project: The Rise and Fall of the British World-System, 1830-1970 - John Darwin
The Endurance: Shackleton's Legendary Antarctic Expedition - Caroline Alexander
The Fatal Shore - Robert Hughes
The Forgotten Founding Father: Noah Webster's Obsession and the Creation of an American Culture - Joshua Kendall
The Fourth Star: Four Generals and the Epic Struggle for the Future of the United States Army - David Cloud, Greg Jaffe
The Gamble: General Petraeus and the American Military Adventure in Iraq - Thomas E. Ricks
The Gathering Storm - Winston Churchill
The Ghosts of Cannae: Hannibal and the Darkest Hour of the Roman Republic - Robert L. O'Connell
The Great Democracies - Winston Spencer Churchill, William Gallup
The Great Depression: America, 1929-1941 - Robert S. McElvaine
The Greater Journey: Americans in Paris - David Mccullough
The Gun - C. J. Chivers
The House of Rothschild: Money's Prophets, 1798-1848 - Niall Ferguson
The House of Rothschild: The World's Banker, 1849-1999 - Niall Ferguson
The Idea of America: Reflections on the Birth of the United States - Gordon S. Wood
The Imperial Cruise: A Secret History of Empire and War - James Bradley
The Indian Ocean - Michael Pearson
The Killer Angels - Michael Shaara
The Killing of Crazy Horse - Thomas Powers
The Known World - Edward P. Jones
The Last Gasp: The Rise and Fall of the American Gas Chamber - Scott Christianson
The Looming Tower - Lawrence Wright
The Loss of the Titanic - Lawrence Beesley
The Lost Chalice: The Epic Hunt for a Priceless Masterpiece - Vernon Silver
The March of Folly: From Troy to Vietnam - Barbara Wertheim Tuchman
The Mental Floss History of the United States: The (Almost) Complete and (Entirely) Entertaining Story of America - Erik Sass, Will Pearson, Mangesh Hattikudur
The Most Powerful Idea in the World: A Story of Steam, Industry, and Invention - William Rosen
The Murder of Jim Fisk for the Love of Josie MAnsfield: A Tragedy of the Gilded Age - H. W. Brands
The Murder of King Tut - James William Patterson, Martin Dugard
The New Jim Crow: Mass Incarceration in the Age of Colorblindness - Michelle Alexander
The Outfit: The Role of Chicago's Underworld in the Shaping of Modern America - Gus Russo
The Pledge: A History of the Pledge of Allegiance - Jeffrey Owen Jones, Peter Meyer
The President and the Assassin: McKinley, Terror, and Empire at the Dawn of the American Century - Scott Miller
The Publisher: Henry Luce and His American Century - Alan Brinkley
The Race Beat - Gene Roberts, Hank Klibanoff, Richard J. Allen
The Relentless Revolution: A History of Capitalism - Joyce Appleby, Joyce Oldham Appleby
The Rise and Fall of Ancient Egypt - Toby A. H. Wilkinson
The Rise and Fall of the Great Powers: Economic Change and Military Conflict From 1500 to 2000 - Paul M. Kennedy
The Road to Disunion: Secessionists at Bay, 1776-1854 - William W. Freehling
The Road to Disunion: Secessionists Triumphant, 1854-1861 - William W. Freehling
The Secret History of MI6 - Keith Jeffery
The Secret History of the Mongol Queens - Jack Weatherford
The Secret History of the World - Jonathan Black
The Shield of Achilles: War, Peace, and the Course of History - Philip Bobbitt
The Song Before It Is Sung - Justin Cartwright
The Super Summary of World History - Alan Dale Daniel
The Surgeon of Crowthorne: A Tale of Murder, Madness and the Oxford English Dictionary - Simon Winchester
The Tin Ticket: The Heroic Journey of Australia's Convict Women - Deborah J. Swiss
The Tudors: The Complete Story of England's Most Notorious Dynasty - G. J. Meyer
The Warmth of Other Suns: The Epic Story of America's Great Migration - Isabel Wilkerson
The White War: Life and Death on the Italian Front 1915-1919 - Mark Thompson
The Wordy Shipmates - Sarah Vowell
The Worst Hard Time: The Untold Story of Those Who Survived the Great American Dust Bowl - Timothy Egan
Their Finest Hour - Winston Churchill
This House of Sky - Ivan Doig
This Republic of Suffering: Death and the American Civil War - Drew Gilpin Faust
Tories: Fighting for the King in America's First Civil War - Thomas B. Allen
Traitor to His Class: The Privileged Life and Radical Presidency of Franklin Delano Roosevelt - H. W. Brands
Trial by Ice: The True Story of Murder and Survival on the 1871 Polaris Expedition - Richard Parry
Tulipomania - Mike Dash
Uncommon Grounds: The History of Coffee and How It Transformed Our World - Mark Pendergrast
Unfamiliar Fishes - Sarah Vowell
Vampire Forensics: Uncovering the Origins of an Enduring Legend - Mark Collins Jenkins
Venice: Pure City - Peter Ackroyd
Waxman Report: How Congress Really Works - Henry A. Waxman, Joshua Green
White Mughals: Love and Betrayal in Eighteenth-Century India - William Dalrymple
Who's Buried in Grant's Tomb?: A Tour of Presidential Gravesites - Brian Lamb, C-Span
Why the West Rules--For Now: The Patterns of History, and What They Reveal About the Future - Ian Morris
Wicked River: The Mississippi When It Last Ran Wild - Lee Sandlin
With the Old Breed: At Peleliu and Okinawa - E. B. Sledge
Women in Purple: Rulers of Medieval Byzantium - Judith Herrin
Ghost on the Throne - James S. Romm
Federalist (Barnes & Noble Classics) - Alexander Hamilton, James Madison
Fannie's Last Supper: Re-Creating One Amazing Meal From Fannie Farmer's 1896 Cookbook - Christopher Kimball
The Taste of Conquest: The Rise and Fall of the Three Great Cities of Spice - Michael Krondl
Great Transformation - Karen Armstrong
Infidels: A History of the Conflict Between Christendom and Islam - Andrew Wheatcroft
Life After Death: A History of the Afterlife in Western Religion - Alan Segal
The Forge of Christendom - Tom Holland
The Story of the Scrolls: The Miraculous Discovery and True Significance of the Dead Sea Scrolls - GÃŒÂ©za VermÃŒÂ¬s
Anatomy of an Epidemic - Robert Whitaker
Cathedral, Forge, and Waterwheel: Technology and Invention in the Middle Ages - Frances Gies, Joseph Gies
Edison and the Electric Chair: A Story of Light and Death - Mark Essig
Engineers of Dreams: Great Bridge Builders and the Spanning of America - Henry Petroski
Galileo's Daughter: A Historical Memoir of Science, Faith, and Love - Dava Sobel
No Bone Unturned: Inside the World of a Top Forensic Scientist and His Work on America's Most Notorious Crimes and Disasters - Jeff Benedict
The Age of Wonder: The Romantic Generation and the Discovery of the Beauty and Terror of Science - Richard Holmes
The Emperor of All Maladies: A Biography of Cancer - Siddhartha Mukherjee
The Ghost Map: A Street, an Epidemic and the Two Men Who Battle to Save Victorian London - Steven Johnson
The Great American Steamboat Race - Benton Rain Patterson
Black Lamb and Grey Falcon: A Journey Through Yugoslavia - Rebecca West, Christopher Hitchens
A Writer at War: Vasily Grossman With the Red Army - Vasily Grossman, Antony Beevor, Luba Vinogradova
Alexander the Great - Robin Lane Fox
Ancient Chinese Warfare - Ralph D. Sawyer
Armageddon - Max Hastings
Band of Brothers: E Company, 506th Regiment, 101st Airborne From Normandy to Hitler's Eagle's Nest - Stephen E. Ambrose
Battle of Britain - Richard Overy
Black Hawk Down: A Story of Modern War - Mark Bowden
Blood and Rage: A Cultural History of Terrorism - Michael Burleigh
Bloodlands - Timothy Snyder
Churchill, Hitler, and "The Unnecessary War": How Britain Lost Its Empire and the West Lost the World - Patrick J. Buchanan
Citizen Soldiers: The U.S. Army From the Normandy Beaches to the Buldge to the Surrender of Germany Jun 7, 1994-May 7, 1945 - Stephen E. Ambrose
Confederates in the Attic - Tony Horwitz
Crucible of War: The Seven Years' War and the Fate of Empire in British North America, 1754-1766 - Fred Anderson
D-Day: The Battle for Normandy - Antony Beevor
Death Valley: The Summer Offensive, I Corps, August 1969 - Keith Nolan
Empire of the Summer Moon - S. C. Gwynne
Ghost Wars - Steve Coll
Grunts: Inside the American Infantry Combat Experience, World War II Through Iraq - John C. McManus
Guns Up! - Johnnie M. Clark
Hiroshima: The World's Bomb - Andrew J. Rotter
Hitler's U-Boat War: The Hunters, 1939-1942 - Clay Blair
Masters and Commanders: How Four Titans Won the War in the West, 1941-1945 - Andrew Roberts
Napoleon's Wars: An International History, 1803-1815 - Charles Esdaile
Not a Good Day to Die: The Untold Story of Operation Anaconda - Sean Naylor
Okinawa: The Last Battle of World War II - Robert Leckie
Operation Mincemeat - Ben Macintyre
Pegasus Bridge: June 6, 1944 - Stephen E. Ambrose
Perilous Fight: America's Intrepid War With Britain on the High Seas, 1812-1815 - Stephen Budiansky
Postwar: A History of Europe Since 1945 - Tony Judt
Short History of World War II - James L. Stokesbury
Stalingrad - Antony Beevor
The American Civil War - John Keegan
The American Civil War and the Wars of the Industrial Revolution - Brian Holden Reid, John Keegan
The American Revolution: A History - Gordon S. Wood
The Battle for Iwo Jima - Robert Leckie
The Battle of Midway - Craig L. Symonds
The Black Banners: 9/11 and the War Against Al-Qaeda - Ali H. Soufan, Daniel Freedman
The Civil War, a Narrative: Fort Sumter to Perryville - Shelby Foote
The Civil War, a Narrative: Red River to Appomattox - Shelby Foote
The Civil War, a Narrative: Shelby Foote - Shelby Foote
The Crimean War: A History - Orlando Figes
The First Battle - Otto J. Lehrack
The First World War - Hew Strachan
The Forever War - Dexter Filkins
The Forgotten 500: The Untold Story of the Men Who Risked All for the Greatest Rescue Mission of World War II - Gregory A. Freeman
The Forgotten Soldier - Guy Sajer
The Ghost Mountain Boys - James E. Campbell
The Guns of August - Barbara Wertheim Tuchman
The Last Stand of the Tin Can Sailors: The Extraordinary World War II Story of the U.S. Navy's Finest Hour - James D. Hornfischer
The Last Stand: Custer, Sitting Bull, and the Battle of the Little Big Horn - Nathaniel Philbrick
The Magnificent Bastards: The Joint Army-Marine Defense of Dong Ha, 1968 - Keith William Nolan
The Marne, 1914: The Opening of World War I and the Battle That Changed the World - Holger H. Herwig
The Monks of War - Desmond Seward
The Monuments Men: Allied Heroes, Nazi Thieves, and the Greatest Treasure Hunt in History - Robert M. Edsel, Bret Witter
The Storm of War - Andrew Roberts
The Things They Carried - Tim O'Brien
The Twilight Warriors: The Deadliest Naval Battle of World War II and the Men Who Fought It - Robert Gandt
The Warrior Elite: The Forging of Seal Class 228 - Dick Couch
The Wars Against Napoleon: Debunking the Myth of the Napoleonic Wars - General Michel, Weider Franceschi
The World at War - Richard Holmes
The Years of Extermination: Nazi Germany and the Jews, 1939-1945 - Saul FriedlÃŒ_nder
This Hallowed Ground - Bruce Catton
To End All Wars: A Story of Loyalty and Rebellion, 1914-1918 - Adam Hochschild
Voices From the Korean War - Douglas Rice
Waterloo: June 18, 1815: The Battle for Modern Europe - Andrew Roberts
Winston's War: Churchill, 1940-1945 - Max Hastings


Autobiography - War

Father of All Things: A Marine, His Son, and the Legacy of Vietnam - Tom Bissell
A Long Way Gone: Memoirs of a Boy Soldier - Ishmael Beah
Auschwitz: A Doctor's Eyewitness Account - Miklos Nyiszli
Bomb Hunters: In Afghanistan With Britain?s Elite Bomb Disposal Unit - Sean Rayment
Devil at My Heels - Louis Zamperini, David Rensin
Dreams in a Time of War: A Childhood Memoir - Ngugi Wa Thiong'o
Escape From Saddam: The Incredible True Story of One Man's Journey to Freedom - Lewis Alsamari
If I Die in a Combat Zone: Box Me Up and Ship Me Home - Tim O'Brien
In Pharaoh's Army: Memories of the Lost War - Tobias Wolff
Joker One: A Marine Platoon's Story of Courage, Leadership, and Brotherhood - Donovan Campbell
Lions of Kandahar - Rusty Bradley, Kevin Maurer
Lone Survivor: The Eyewitness Account of Operation Redwing and the Lost Heroes of SEAL Team 10 - Marcus Luttrell, Patrick Robinson
Mass Casualties: A Young Medic's True Story of Death, Deception, and Dishonor in Iraq - Michael Anthony
One Bullet Away - Nathaniel Fick
Seven Troop - Andy McNab
Shooter: The Autobiography of the Top-Ranked Marine Sniper - Jack Coughlin, Donald G. Davis, Casey Kuhlman
Spoken From the Front - Andy McNab
The Dressmaker of Khair Khana - Gayle Tzemach Lemmon
The Forgotten Highlander - Alistair Urquhart
The Heart and the Fist: The Education of a Humanitarian, the Making of a Navy SEAL - Eric Greitens
The Taliban Shuffle: Strange Days in Afghanistan and Pakistan - Kim Barker



Enjoy and Seed!!