Best Picture - 1953 - From Here to Eternity

Video Codec..........: XviD ISO MPEG-4 
Video Bitrate........: 1103kbps 
Duration.............: 1:58:02
Resolution...........: 600*454 
Framerate............: 23.976 
Audio Codec..........: 0x2000 (Dolby AC3) AC3 
Audio Bitrate........: 192 kbps CBR 
Audio Channels.......: 2 
Filesize.............: 1,156,116,450 
SUBTITLES............: French, English, Spanish, Portuguese, Chinese, Thai, Korean
 
http://www.imdb.com/title/tt0045793/
 
http://en.wikipedia.org/wiki/From_Here_to_Eternity
 
http://bayimg.com/dAKAEAaDP


From Here to Eternity is a 1953 drama film directed by Fred Zinnemann and based on the novel of the same name by James Jones. It deals with the troubles of soldiers, played by Burt Lancaster, Montgomery Clift, Frank Sinatra and Ernest Borgnine stationed on Hawaii in the months leading up to the attack on Pearl Harbor. Deborah Kerr and Donna Reed portrayed the women in their lives.

The film won eight Academy Awards out of 13 nominations, including Best Picture, Best Director (Fred Zinnemann), Best Writing, Adapted Screenplay, Best Supporting Actor (Frank Sinatra) and Best Supporting Actress (Donna Reed).

Cast

Burt Lancaster 		as First Sergeant Milton Warden
Montgomery Clift 	as Private Robert E. Lee Prewitt
Deborah Kerr 		as Karen Holmes
Donna Reed 		as Alma 'Lorene' Burke
Frank Sinatra 		as Private Angelo Maggio
Philip Ober 		as Captain Dana "Dynamite" Holmes
Mickey Shaughnessy 	as Corporal Leva
Harry Bellaver 		as Private First Class Mazzioli
Ernest Borgnine 	as Staff Sergeant James R. "Fatso" Judson
Jack Warden 		as Corporal Buckley
John Dennis 		as Sergeant Ike Galovitch
Merle Travis 		as Sal Anderson
Tim Ryan 		as Sergeant Pete Karelsen
Arthur Keegan 		as Treadwell
Barbara Morrison 	as Mrs. Kipfer
George Reeves 		as Sergeant Maylon Stark
Claude Akins 		as Sergeant 'Baldy' Dhom
Alvin Sargent 		as Nair
Joseph Sargent 		as soldier
Robert J. Wilke 	as Sergeant Henderson
Carleton Young 		as Colonel Ayres
Tyler McVey 		as Major Stern (uncredited)

The novel's author, James Jones, had a small, uncredited part.

Academy Awards

Best Picture		Won	Buddy Adler
Best Director		Won	Fred Zinnemann
Best Actor		Nom	Montgomery Clift
Best Actor		Nom	Burt Lancaster
Best Actress		Nom	Deborah Kerr
Best Writing Screenplay	Won	Daniel Taradash
Best Supporting Actor	Won	Frank Sinatra
Best Supporting Actress	Won	Donna Reed
Best Cinematography (Black-and-White)	Won	Burnett Guffey
Best Costume Design (Black-and-White)	Nominated	Jean Louis
Best Film Editing	Won	William A. Lyon
Best Score of a Dramatic or Comedy Picture	Nominated	George Duning and Morris Stoloff
Best Sound (Recording)	Won	John P. Livadary
