Merry Xmas - varius

01. All I Want For Christmas Is You (LP Version) 	Mariah Carey 		
02. Do They Know It's Christmas? 	Band Aid 	
03. Last Christmas (Single Version) 	Wham! 	
04. Merry Christmas Everyone 	Shakin' Stevens 	
05. I Wish It Could Be Christmas Everyday 	Girls Aloud 	
06. Christmas Tree 	Lady Gaga Feat. Space Cowboy 	
07. Happy New Year 	Abba 	
08. Mary's Boy Child / Oh My Lord 	Boney M. 	
09. Santa Baby 	The Pussycat Dolls 	3:00 	Album Only 	  	
10. The Christmas Song (Holiday Remix) 	Christina Aguilera 	
11. Fairytale Of New York 	Ronan Keating Feat. Maire Brennan 	
12. Dream A Dream 	Charlotte Church 		
13. Warm This Winter 	Gabriella Cilmi 	
14. Feels Like Christmas 	The Feeling 	
15. Step Into Christmas (Radio Mix) 	Elton John 	
16. Frosty The Snowman 	Jackson 5 	
17. Merry Christmas Baby 	Elvis Presley 	
18. Santa Claus Is Comin' To Town 	Frank Sinatra; Orchestra under the direction of Axel Stordahl 	
19. White Christmas 	Bing Crosby 	
20. Driving Home For Christmas 	Chris Re