TÃTULO ORIGINAL 	Manhattan
AÃ‘O 	
1979 	
DURACIÃ“N 	
96 min. 	  Trailers/VÃ­deos
PAÃS 	
[Estados Unidos] 	 
DIRECTOR 	Woody Allen
GUIÃ“N 	Woody Allen & Marshall Brickman
MÃšSICA 	George Gershwin
FOTOGRAFÃA 	Gordon Willis (B&W)
REPARTO 	Woody Allen, Diane Keaton, Michael Murphy, Meryl Streep, Mariel Hemingway, Anne Byrne
PRODUCTORA 	United Artists presenta una producciÃ³n Jack Rollins / Charles H. Joffe
PREMIOS 	1979: 2 Nominaciones al Oscar: Actriz secundaria (Mariel Hemingway), guiÃ³n
1979: BAFTA: Mejor pelÃ­cula
GÃ‰NERO 	Comedia. Drama. Romance | Comedia romÃ¡ntica. Cine independiente USA
SINOPSIS 	PodrÃ­a decirse que Isaac Davis, un neoyorquino de mediana edad, lo tiene todo, si por todo entendemos un trabajo que odia, una novia de 17 aÃ±os a la que no ama y una ex-esposa lesbiana a la que desearÃ­a estrangular, porque estÃ¡ escribiendo un libro en el que cuenta las intimidades de su matrimonio. Pero su vida cambia cuando conoce a Mary, la sexy e inteligente amante de su mejor amigo, y se enamora perdidamente de ella. Dejar a su novia, acostarse con Mary y abandonar su trabajo no es mÃ¡s que el comienzo de la bÃºsqueda de sÃ­ mismo. (FILMAFFINITY)

CRÃTICAS 	----------------------------------------
"Allen se supera a sÃ­ mismo en esta legendaria pelÃ­cula. Tras abandonar las comedias delirantes de su primera Ã©poca ya habÃ­a sorprendido con 'Annie Hall' e 'Interiores', pero ahora ofrece una deliciosa obra maestra que hace de la ciudad de Manhattan un personaje mÃ¡s de la funciÃ³n." (Miguel Ãngel Palomo: Diario El PaÃ­s)
----------------------------------------