DISCS ARE NOT NUMBERED

192kps


Disc 1:
Taio Cruz - Dynamite - Stonebridge Edit
Florida Ft David Guetta - Club Can't Handle Me - Felguk Remix
Dcup & Pablo Calamari - Boogie Down
Kate Perry Feat Snoop Dog - Californian Girls - Manhattan Clique Mix
Yolanda Be Cool & Dcup Feat Nabilion - I Like That
Akon, Kylian Mash & Glasses Malone - Club Certified
Swedish House Mafia Feat Pharrel - One
Ricky L - Born Again - Balearic Soul Club Mix
Chris Willis - Louder (Put Your Hands Up)
Deekline - Smash The Pressure
Dons Feat Seany B - Rolling Deep - Denzel Park Remix
P Money Feat Pnc & Vince Harder - Dance With Me - Special Ed Mix
Ian Carey - Let Loose
Adrian Lux - Teenage Crime
Gina Star - I Want It Now
Zoe Badwi - Freefalling - Edit
The Underdog Project - Summer Jam 2010 - Eric Chase Remix
Inna - Amazing - Dj Feel Mix
Edward Maya - This Is My Life - Adi Perez 10" Mix
The Potbelleez - Hello
Basshunter - Saturday - Digital Dog Remix
Weekend Warriors - F@@k You - Cee Lo Bangstar Mix

Disc 2:
Vampire Weekend - White Sky - Basement Jaxx Remix
Dirty South - Phazing - Tiesto Mix
Faithless Featuring Dido - Feeling Good - Ferry Corsten Fix
Tomcraft - Room 414 (Can;t Get Away) - Citzen Kane Remix
Nalin & Kane - Beachball - Chris Lakes Mix
Chicane - Middledistancerunner -
Switchfoot - Always - Max Vangeli Mix
Erick Morillo Feat Cutler - Alive -
Ou Est Le Swimming Pool - Jackson's Last Stand - Those Usual Suspects Mix
Tensnake - Coma Cat - Round Table Knights Mix
Monkey Safari - Dancing Days -
Adam Port & Sante - Own - Riva Star Remix
Picco - Venga - Chuckie Back To Voltage Remix
Jean Elan - What It Takes - Klik Klak Mix
Klaas - It's My Day - Bodybangers Remix
Dennis Koyu - Lose Control - Johan Wedel Mix
Jeko - Geek -
Kelis - 4th July (Fireworks) - Calvin Harris Mix
Kernkraft 440 - Zombie Nation - The Only Bootleg Remix
Bombs Away - Big Booty Bitches - Dirty Loud Mix
Freestylers - Cracks - Cntl Z Mix
Danny Byrd - Ill Behaviour