TÃTULO ORIGINAL 	The Pelican Brief
AÃ‘O 	
1993 	
DURACIÃ“N 	
141 min. 	  Trailers/VÃ­deos
PAÃS 	
[Estados Unidos] 	  SecciÃ³n visual
DIRECTOR 	Alan J. Pakula
GUIÃ“N 	Alan J. Pakula (Novela: John Grisham)
MÃšSICA 	James Horner
FOTOGRAFÃA 	Stephen Goldblatt
REPARTO 	Julia Roberts, Denzel Washington, Sam Shepard, Tony Goldwyn, John Heard, James B. Sikking, John Lithgow, Robert Culp, Hume Cronyn, William Atherton, Stanley Tucci, Jake Weber, Anthony Heald, Cynthia Nixon
PRODUCTORA 	Warner Bros. Pictures
GÃ‰NERO 	Intriga
SINOPSIS 	Darby Shaw (Julia Roberts), una estudiante de derecho, escribe un informe en el que analiza las posibles razones del reciente asesinato de dos jueces del Tribunal Supremo. Su informe, en principio descabellado, parece que toca material "sensible", pues pronto serÃ¡ objeto de una implacable persecuciÃ³n, de la que saldrÃ¡ con vida gracias a la ayuda de un periodista (Denzel Washington) que tambiÃ©n quiere descubrir quiÃ©nes estÃ¡n detrÃ¡s de esos asesinatos. (FILMAFFINITY)

CRÃTICAS 	----------------------------------------
Dos jueces del Tribunal Supremo de Justicia americano son asesinados, y una simple estudiante de derecho escribe una rebuscada teorÃ­a sobre las causas y culpables del asesinato. Sin embargo el informe, aparentemente basado en especulaciones, llega a las altas esferas... poniendo su vida en peligro. De nuevo otro best seller de John Grisham (The Firm, The Client) se adapta a la gran pantalla consiguiendo un gran Ã©xito de taquilla. Lo mejor: en su primera hora el suspense se apodera formidablemente del espectador, fascinado por el contenido e influencia del misterioso "informe". Lo peor: paradÃ³jicamente, la importancia de la intriga lo eclipsa prÃ¡cticamente todo (incluso el devenir del informe llega a interesar mÃ¡s que el de los personajes), asÃ­ que una vez desvelada tanta curiosidad todo se vuelve bastante intrascendente. En definitiva, "The Pelican Brief" es una entretenida y comercial intriga, de dosificada trama, aunque excesivamente larga. (Pablo Kurt: FILMAFFINITY)
----------------------------------------
"Como la atmÃ³sfera estÃ¡ hÃ¡bilmente conseguida, su reparto es bueno y Pakula sabe cÃ³mo construir escenas efectivas, la peli funciona. Que no contenga sustancia o propÃ³sito no es su problema. Es un inteligente intrumento para apartarte de tus problemas durante 141 minutos." (Roger Ebert: Chicago Sun-Times)
----------------------------------------
"Mayormente esta es una pelÃ­cula sobre gente subiÃ©ndose y bajÃ¡ndose de coches, que pueden o no explotar cuando encienden el motor. (...) Las pelÃ­culas requieren algo mÃ¡s que conexiÃ³n entre escenas, aunque estÃ©n magnÃ­ficamente elaboradas." (Richard Schickel: Time) 