Here are more song offerings from the 50s period 3CD set - Remembering the 50s
from Readers Digest Music - we have other more elaborate postings already
provided for you here But then you shouldn't miss out on a thing from this
music genre I say! nice 192k bitrate for you too -

Michael Rizzo Chessman
musicfromrizzo


Disc1 - Readers Digest - Remembering The 50's 
Al Martino - Here In My Heart
Ames Brothers - Sentimental Me
Ames Brothers - Undecided
Bing & Gary Crosby - Sam's Song ( The Happy Song)
Dinah Shore - Sweet Violets
Don Cornell - I'll Walk Alone
Eddie Fisher - Any Time
Ella Mae Morse - The Blacksmith Blues
Frankie Laine - The Cry Of The Wild Goose
Georgia Gibbs - Kiss Of Fire
Guy Lombardo & The Royal Canadians - The Third Man Theme
Jo Stafford - You Belong To Me
Kay Starr - Bonaparte's Theme
Les Paul & Marry Ford - The World Is Waiting For The Sunrise
Patti Page - Mockin' Bird Hill
Perry Como - If
Vaughn Monroe - Sound Off (The Duckworth Chant)
Weavers - Goodnight Irene
 
Disc2 - Readers Digest - Remembering The 50's 
Al Hibler - Unchained Melody
Archie Bleyer - Hernando's Hideaway
Billy Vaughn & His Orchestra - Melody Of LOve
Ertha Kitt - C'Est Si Bon (It's So Good)
Georgia Gibbs - Dance With Me Henry
Henri Rene & His Orchestra - The Happy Wanderer
Hugo Winterhalter & His Orchestra - Canadian Sunset
Julius LeRossa - Eh, Cumpari
Kitty Kallen - Little Things Mean A Lot
Les Baxter & His Orchestra - April In Portugal
Les Paul & Mary Ford - Vaya Con Dios
Perez Prado & His Orchestra - Cherry Pink And Apple Blossom Whith
Perry Como - More
Richard Hayman - Ruby
Teresa Brewer - Let Me Go Lover
The Chordettes - Born To Be With You
The Dream Weavers - It's Almost Tomorrow
The Four Aces - Stranger In Paradise
The Four Knights - Oh, Baby Mine ( I Get So Lonely)
The Gaylords - The Little Shoemaker
The Hilltoppers - P. S. I Love You

 
Disc3 - Readers Digest - Remembering The 50's 
Billy Ward & The Dominoes - Star Dust
Billy Williams - I'm Gonna Sit Right Down And Write Myself A Letter
Brook Benton - It's Just A Matter Of Time
Connie Francis - My Happiness
Dean Martin - Return To Me
Ed Townsend - For Your Love
Gale Storm - Dark Moon
Jackie Wilson - Lonely Teardrops
Jimmie Rodgers - Kisses Sweeter Than Wine
Morris Stoloff - Moonglow And Theme From Picnic
Pat Boone - April Love
Patience & Prudence - Tonight You Belong To Me
Paul Anka - Put Your Head On My Shoulder
Peggy lee - Fever
Perry Como - Magic Moments
The Everly Brothers - Devoted To You
The Flamingos - I Only Have Eyes For You
The Four Preps - Twenty-Six Miles
The Platters - (You've Got) The Magic Touch
The Skyliners - Since I Don't Have You
The Tarriers - The Banana Boat Song (Day O) The Tarriers

 