
Dear friends, im back from prison. and the updates are back :=)


Check out my site: www.themusix.net

This Vol. contains music from january 2011 till today :)

Thanks for all the comments and the seeding

Like us on Facebook:

Join our group on facebook:


Enjooooooy <3 <3 love you all :=) respect to all rnb & hiphop fans


===========================================================================


Deadmau5 - HR 8938 Cephei (Original Mix) [ www.theMusix.net ].mp3	24.76 MiB
Laulelei Manu - Hehhh - Original Mix [ www.theMusix.net ].mp3	22.16 MiB
Journey - Dont Stop Believin (Felix Voya Remix) [ www.theMusix.net ].mp3	21.39 MiB
Scot Project & Supermusique! - Do You Want Me (Scot Project Remix) [ www.theMusix.net ].mp3	19.11 MiB
System Deejay feat. Radio Lynx - Relax Your Body (Original Radio Edit) [ www.theMusix.net ].mp3	19.06 MiB
Mark Knight & Funkagenda - Antidote (JunkDNA Remix) [ www.theMusix.net ].mp3	19.02 MiB
KORT - Tomorrow [ www.theMusix.net ].mp3	18.84 MiB
Mory Kante - Yeke Yeke 2011 (Robbie Rivera Mix) [ www.theMusix.net ].mp3	18.75 MiB
Bentu De Soli (Laurentiu Duta) - Pearls Of Summer (Dotix Remix) [ www.theMusix.net ].mp3	18.23 MiB
Jordan Suckley feat. NASA - Rokit (Original Mix) [ www.theMusix.net ].mp3	18.02 MiB
Paul Thomas - Ultraviolet [ www.theMusix.net ].mp3	17.77 MiB
The Wombats - Techno Fan (Afrojack Extended Club Remix) [ www.theMusix.net ].mp3	17.69 MiB
Alex Pich & Shinobi - Barcelona (Original Mix) [ www.theMusix.net ].mp3	17 MiB
Mijail & Soultwister - Carte Blanche (Original Mix) [ www.theMusix.net ].mp3	16.99 MiB
Peter Gelderblom - Waiting 4 (Tim Royko Remix) [ www.theMusix.net ].mp3	16.75 MiB
Jerome Isma-Ae, Snap - Cult Of Snap (D-Nox & Vincent Thomas Remix) [ www.theMusix.net ].mp3	16.65 MiB
Max Farenthide - 1, 2, 3, Four, Max Is On The Floor (Club Mix) [ www.theMusix.net ].mp3	16.43 MiB
Nadia Ali - Rapture (Avicii New Generation Extended Mix) [ www.theMusix.net ].mp3	16.35 MiB
Alex Gaudino - Miami Penthouse (Original Mix) [ www.theMusix.net ].mp3	16.1 MiB
Jennifer Lopez feat. Lil Wayne - I'm Into You (Dave Aude Club Mix) [ www.theMusix.net ].mp3	16.09 MiB
Josh Newson & Jay Ronko - Love Excels (Original Club Mix) [ www.theMusix.net ].mp3	16.08 MiB
Innate - Late Night Surfin (Manuel De La Mare Remix) [ www.theMusix.net ].mp3	15.98 MiB
Mark Simmons - Good - Original Mix [ www.theMusix.net ].mp3	15.96 MiB
iiO ft. Nadia Ali - It'll Be Like (Extended Club Mix) [ www.theMusix.net ].mp3	15.82 MiB
Marc Korn Feat. Natasha Anderson - Fairytale Of Yesterday (Darius And Finlay Club Mix) [ www.theMusix.net ].mp3	15.8 MiB
Stan Courtois & Felly vs Cutting Crew - Die In Your Arms (X-centrik Mix) [ www.theMusix.net ].mp3	15.75 MiB
Marcus Maison & Will Dragen - Another Dimension (Original Mix) [ www.theMusix.net ].mp3	15.54 MiB
Josh Newson & Jay Ronko - We Are Naive (Original Club Mix) [ www.theMusix.net ].mp3	15.54 MiB
Nari & Milani and Cristian Marchi feat. Shena - Take Me to the Stars (Cristian Marchi & Paolo Sandrini Flow Mix) [ www.theMusix.net ].mp3	15.33 MiB
DBN & Matty Menck ft. Rosie Henshaw - Redemption (Alex Lamb Remix) [ www.theMusix.net ].mp3	15.24 MiB
Mark Knight & Funkagenda - Antidote (Sonny Wharton Remix) [ www.theMusix.net ].mp3	15.22 MiB
Antranig - Back That Up (Original Mix) [ www.theMusix.net ].mp3	15.08 MiB
Incognet - Relationships (Original Mix) [ www.theMusix.net ].mp3	15.08 MiB
B-Ju - Babbel Net (Original Mix) [ www.theMusix.net ].mp3	15.05 MiB
Hardwell - Encoded - Original Mix [ www.theMusix.net ].mp3	15.03 MiB
No Body - We Speak American (Original Mix) [ www.theMusix.net ].mp3	15.02 MiB
Kim Fai - Zen (Original Club Mix) [ www.theMusix.net ].mp3	14.91 MiB
Emil Lassaria & Dj Andi - Unstopable 2011 (Extended Mix) [ www.theMusix.net ].mp3	14.78 MiB
Swedish House Mafia - Save The World (Bastian Van Shield Remix) [ www.theMusix.net ].mp3	14.74 MiB
Laidback Luke & Steve Aoki Feat. Lil Jon - Turbulence [ www.theMusix.net ].mp3	14.73 MiB
David Guetta feat. Nicki Minaj & Flo Rida - Where Dem Girls At (Afrojack Remix) [ www.theMusix.net ].mp3	14.73 MiB
Diddy-Dirty Money feat. Swizz Beatz - Ass on the Floor (Zedd Remix) [ www.theMusix.net ].mp3	14.56 MiB
Leon Lopez, Paul James - Toxic Love Affair (Adrial Torres Heartless Remix) [ www.theMusix.net ].mp3	14.55 MiB
Cedric Cadieux - Rebirth (Original Mix) [ www.theMusix.net ].mp3	14.36 MiB
Laidback Luke & Steve Aoki feat. Lil Jon - Turbulence (Sidney Samson Remix) [ www.theMusix.net ].mp3	14.27 MiB
Dan Balan - Chica Bomb (Dj Goksel Candan Club Mix) [ www.theMusix.net ].mp3	14.16 MiB
DJ PP - Havana (Original Mix) [ www.theMusix.net ].mp3	14.14 MiB
Rico Bernasconi - Tearing Up The Club (Club Mix) [ www.theMusix.net ].mp3	14.1 MiB
Wiz Khalifa - Homicide (Remix) feat Chevy Woods & Young Jeezy [ www.theMusix.net ].mp3	14.05 MiB
Bingo Players & Nicky Romero - - Sliced (Original Mix) [ www.theMusix.net ].mp3	14.03 MiB
Sunrise Inc - Forever in my soul (Sloupi & Dj Boby remix) [ www.theMusix.net ].mp3	14.02 MiB
Nari & Milani - Kendo (Original Mix) [ www.theMusix.net ].mp3	14.01 MiB
Axwell & Dirty South vs Tim Mason - The Moment Your Heart (Inphinity Bootleg) [ www.theMusix.net ].mp3	13.98 MiB
Chris Brown ft. Benny Benassi - Beautiful People (Disco Fries Remix) [ www.theMusix.net ].mp3	13.97 MiB
Tim Mason - The Moment (Steve Angello Edit) [ www.theMusix.net ].mp3	13.97 MiB
Pitbull Feat. Ne-Yo, Afrojack & Nayer - Give Me Everything (Jump Smokers Remix) [ www.theMusix.net ].mp3	13.96 MiB
Double Stars feat. Mike W - I Still Believe (Check Dance Remix) [ www.theMusix.net ].mp3	13.95 MiB
Swedish House Mafia feat. John Martin - Save The World (Extended Mix) [ www.theMusix.net ].mp3	13.92 MiB
Rob Pix ft. Seany B - Gadunk (Original Mix) [ www.theMusix.net ].mp3	13.89 MiB
Manuel De La Mare, Paul Thomas - Circle Of Life (Original Mix) [ www.theMusix.net ].mp3	13.82 MiB
Gregori Klosman - Low Battery (Original Mix) [ www.theMusix.net ].mp3	13.82 MiB
Nadia Ali, Starkillers & Alex Kenji - Pressure (Original Mix) [ www.theMusix.net ].mp3	13.77 MiB
Afrojack & R3hab - Aces High Prutata (Original Mix) [ www.theMusix.net ].mp3	13.75 MiB
DJ Sava feat. Andreea D. & J. Yolo - Money Maker (Gino Manzotti Remix [ www.theMusix.net ].mp3	13.65 MiB
Muttonheads, Eden Martin - Trust You Again (John Revox Remix) [ www.theMusix.net ].mp3	13.58 MiB
Kanye West Ft. Lil Wayne, Drake & Big Sean - All Of The Lights (Remix) [ www.theMusix.net ].mp3	13.55 MiB
Jadyn Maria feat. Flo Rida - Good Girls Like Bad Boys (BuzzShakerZz Remix) [ www.theMusix.net ].mp3	13.25 MiB
Afrojack & Quintino - Selecta (Original Mix) [ www.theMusix.net ].mp3	13.25 MiB
Bytesize - Platonic [www.clubmuzon.com] [ www.theMusix.net ].mp3	13.22 MiB
FNA - Take Me Home (The House Moguls Remix) [ www.theMusix.net ].mp3	13.16 MiB
Snoop Dogg - Wet (David Guetta Extended Mix) [ www.theMusix.net ].mp3	13.06 MiB
James Ash & Denzal Park - Titans (Denzal Park Remix) [ www.theMusix.net ].mp3	13.06 MiB
Matt Pokora - Hey Girl [ www.theMusix.net ].mp3	12.84 MiB
Henrik B - Acid Rocker (David Tort Remix) [ www.theMusix.net ].mp3	12.76 MiB
Bass N Whomps - Ghost (Original Mix) [ www.theMusix.net ].mp3	12.75 MiB
Avicii - Levels (ID) (Original Mix) [ www.theMusix.net ].mp3	12.73 MiB
MERCER vs FAR EAST MOVEMENT - MERCER vs FAR EAST MOVEMENT - Get Up Like a G6 (Mercer bootleg) [ www.theMusix.net ].mp3	12.68 MiB
Jason Derulo - Celebrity Love (Critz Remix) [ www.theMusix.net ].mp3	12.66 MiB
Avici feat. Tim Berg - Levels Bromance (Micho Mash-Up) [ www.theMusix.net ].mp3	12.61 MiB
Example - Changed The Way You Kiss Me (Extended Mix) [ www.theMusix.net ].mp3	12.6 MiB
Tommy Trash - The End (Original Mix) [ www.theMusix.net ].mp3	12.6 MiB
DJ Epic - S&M Animal Party [ www.theMusix.net ].mp3	12.42 MiB
HeavyFeet, Hannah T - Just Fall (Dillon Francis Remix) [ www.theMusix.net ].mp3	12.41 MiB
Sonny Flame - The day of my life (DJ Misterio Private Remix) [ www.theMusix.net ].mp3	12.33 MiB
DeAngelo Redman - Hurricane [ www.theMusix.net ].mp3	12.3 MiB
Errio - Out Of Time (Florian Rise Extended mix) [ www.theMusix.net ].mp3	12.3 MiB
Catwork Remix Engineers - Like A G6 (Club Remix) [ www.theMusix.net ].mp3	12.24 MiB
Klinqe - Da Glass (Taz Dk Remix) [ www.theMusix.net ].mp3	12.21 MiB
T.I. ft. Eminem - That's All She Wrote [ www.theMusix.net ].mp3	12.15 MiB
Mia Martina - qLatin Moon (Jump Smokers Extended Mix) [ www.theMusix.net ].mp3	12.05 MiB
Hardwell - Encoded - Dada Life Remix [ www.theMusix.net ].mp3	12.01 MiB
Madcon feat. Maad Moiselle - Outrun The Sun (Cosmic Dawn Club Mix) [ www.theMusix.net ].mp3	11.89 MiB
Inventive Sound - Out Of Love (Extended) [ www.theMusix.net ].mp3	11.85 MiB
Calvertron - Future Proof (Original Mix) [ www.theMusix.net ].mp3	11.85 MiB
Raaban & Evana feat. Play-Mate - Nightwalkers (Extended Mix) [ www.theMusix.net ].mp3	11.77 MiB
Kaffein vs. Ace Of Base - All That She Wants (DJ Nejtrino & DJ Stranger Remix) [ www.theMusix.net ].mp3	11.73 MiB
B-Style & Rymit - Hell & Paradise (Vova Baggage Remix) [ www.theMusix.net ].mp3	11.6 MiB
Inna - Sun Is Up (DJ Nejtrino & DJ Stranger Remix [ www.theMusix.net ].mp3	11.56 MiB
Jessie J - Nobody's Perfect (Netsky Remix) [ www.theMusix.net ].mp3	11.55 MiB
Kardinal Offishall Ft. Pitbull, Lil Jon & Clinton Sparks - Smash The Club [ www.theMusix.net ].mp3	11.53 MiB
Paz Yenni Feat. Papa - Balagan (Club Mix) [ www.theMusix.net ].mp3	11.53 MiB
Pretty Ricky Ft. Snoop Dogg & Trick Daddy - Topless [ www.theMusix.net ].mp3	11.5 MiB
Wolfgang Gartner - Space Junk (OVERWERK Remix) [ www.theMusix.net ].mp3	11.49 MiB
Die Atzen Mit Nena - Strobo Pop (Extended Version) [ www.theMusix.net ].mp3	11.45 MiB
YC Ft. Wiz Khalifa - Racks (Remix) [ www.theMusix.net ].mp3	11.43 MiB
Wiz Khalifa Feat. Chevy Woods - Homicide [ www.theMusix.net ].mp3	11.32 MiB
Petros T feat John Marr vs Wippennberg & Rihana - S&M Pong (Petros T Remix) [ www.theMusix.net ].mp3	11.28 MiB
Rihanna - Love The Way You Lie (Marco Belz Unreleased Remix) [ www.theMusix.net ].mp3	11.27 MiB
Roksonix & Statelapse - Letâ€™s Go [ www.theMusix.net ].mp3	11.24 MiB
Carl Louis, Martin Danielle - I'm Coming Home With You - Dub [ www.theMusix.net ].mp3	11.19 MiB
Emalkay - True Romance [ www.theMusix.net ].mp3	11.17 MiB
Toddla T feat. Shola Ama & J2K - Take It Back (Dillon Francis Remix) [ www.theMusix.net ].mp3	11.17 MiB
Evanescence, Trowa - Missing (Trowa Remix) [ www.theMusix.net ].mp3	11.01 MiB
Lil Wayne Ft. Rick Ross - If I Die Today [ www.theMusix.net ].mp3	10.97 MiB
Akon Ft. Big Meech - Time Is Money (Mastered) [ www.theMusix.net ].mp3	10.85 MiB
YC Feat. Twista - Racks On Racks (Remix) [ www.theMusix.net ].mp3	10.83 MiB
Miami Rockers - Good Morning Miami (Dj Jump Extended Mix) [ www.theMusix.net ].mp3	10.82 MiB
Nero - Guilt (Original Mix) [ www.theMusix.net ].mp3	10.8 MiB
Jennifer Lopez Feat. Pitbull - On The Floor (Prod. By RedOne) (Club Version) [ www.theMusix.net ].mp3	10.8 MiB
Ellie Goulding - Lights (Bassnectar Remix) [ www.theMusix.net ].mp3	10.74 MiB
Flinch - Don't Look Back [ www.theMusix.net ].mp3	10.67 MiB
Celia - D-D-Down (Extended version) [ www.theMusix.net ].mp3	10.65 MiB
Tom Boxer Feat. Antonia - Morena (Digital Nova Remix) [ www.theMusix.net ].mp3	10.63 MiB
Yung Berg Feat. Brisco, Chad, Young Chris, Ice Berg, Freddy P, Guyana, Jordon Hollywood, Ball Greezy & Diego Cash - The Cypher [ www.theMusix.net ].mp3	10.58 MiB
Royce Da 5'9 Ft. Eminem - Writer's Block [ www.theMusix.net ].mp3	10.51 MiB
Mobb Deep - Dog Shit (Feat. Nas) [ www.theMusix.net ].mp3	10.36 MiB
Faydee - Better Of Alone (Dj Casino New Version) [ www.theMusix.net ].mp3	10.33 MiB
Jay Sean ft. Pitbull - Do It For You (Jongzki Remix) [ www.theMusix.net ].mp3	10.33 MiB
Bobby Tinsley - I feel good (DJ Juice Transition) [ www.theMusix.net ].mp3	10.32 MiB
Chris Brown Ft. Ludacris - Wet The Bed [ www.theMusix.net ].mp3	10.17 MiB
Chris Brown Ft. Justin Bieber - Next 2 U [ www.theMusix.net ].mp3	10.15 MiB
REEA - Pleasure Boy (Florian Rise Extended Mix) [ www.theMusix.net ].mp3	10.12 MiB
Dan Balan - Justify Sex (DJ Nejtrino, DJ Stranger Remix) [ www.theMusix.net ].mp3	10.11 MiB
Inna - No Limit (Love Clubbing Play & Win Club Mix 2010) __[ www.theMusix.net ].mp3	10.1 MiB
Wale,Meek Mill,Pill & Rick Ross - By Any Means [ www.theMusix.net ].mp3	10.05 MiB
Tech N9ne Ft. Yelawolf, Busta Rhymes, Twista, Ceza, JL B.Hood, Uso, D-Loc & Twisted Insane - Worldwide Choppers [ www.theMusix.net ].mp3	9.9 MiB
Mya Ft. Trae Tha Truth - Full Service [ www.theMusix.net ].mp3	9.89 MiB
Deadmau5 - Raise Your Weapon (Madeon Extended Remix) [ www.theMusix.net ].mp3	9.82 MiB
Reality - Shawty Windin [ www.theMusix.net ].mp3	9.81 MiB
Shaggy Ft. Cecile - Can You Make Me [ www.theMusix.net ].mp3	9.74 MiB
Akon - Time Is Money (New Version) [ www.theMusix.net ].mp3	9.72 MiB
TC Johnston feat. Conor Maynard - My Last [ www.theMusix.net ].mp3	9.69 MiB
Yung Berg - Rollin (Prod. by Sarom) feat Young Lo [ www.theMusix.net ].mp3	9.65 MiB
Helena Paparizou - Love Me Crazy [ www.theMusix.net ].mp3	9.59 MiB
DJ SNAKE - Party All Day [ www.theMusix.net ].mp3	9.58 MiB
Hurts_Millons Like Us - Stay (Millions Like Us Remix) [ www.theMusix.net ].mp3	9.57 MiB
Eminem & Royce Da 5'9 - Fast Lane [ www.theMusix.net ].mp3	9.57 MiB
Brandon Beal - Celebrity Girl [ www.theMusix.net ].mp3	9.56 MiB
Chrishan - Here On Earth (feat. Che'Nelle) [ www.theMusix.net ].mp3	9.54 MiB
Desaparecidos Feat. Big Ali - Go Crazy (D-Bass Remix) - Desaparecidos Feat. Big Ali - Go Crazy (D-Bass Remix) [ www.theMusix.net ].mp3	9.44 MiB
Virtual feat. Irina - Summer Dream (Original Radio Edit) [ www.theMusix.net ].mp3	9.43 MiB
David Correy Feat. DJ Paul - I'm On [ www.theMusix.net ].mp3	9.42 MiB
Ty$ Feat. Bobby Brackins - Naked [ www.theMusix.net ].mp3	9.39 MiB
Edward Maya ft Vika Jigulina - Desert Rain [ www.theMusix.net ].mp3	9.39 MiB
Anda Adam - Trust (Dj U.D. and Jowin Mix) [ www.theMusix.net ].mp3	9.38 MiB
Hot Rod Ft. Ne-Yo & Afrojack - Give Me Everything (Tonight) (Remix) [ www.theMusix.net ].mp3	9.35 MiB
Bruno Mars - On Fire (DJ Tune Cee Clubmix DJ Juice Edit) [ www.theMusix.net ].mp3	9.33 MiB
Sean Garrett Feat. Rick Ross - In Da Box (Prod. By Lex Luger) [ www.theMusix.net ].mp3	9.3 MiB
Desaparecidos ft. Big Ali - Go Crazy (Sergio Mauri Rmx) [ www.theMusix.net ].mp3	9.28 MiB
Boogz Boogetz - On The Regular Feat. Young Scolla [ www.theMusix.net ].mp3	9.27 MiB
Akon - One More Time (Full) [ www.theMusix.net ].mp3	9.19 MiB
Akon - Akon - One More Time (Full) [ www.theMusix.net ].mp3	9.19 MiB
Iyaz Feat. Diction & Lil Mo - Yeah 3x (Remix) [ www.theMusix.net ].mp3	9.18 MiB
T'Nez - Tell Me [ www.theMusix.net ].mp3	9.14 MiB
Mike Posner - The Scientist [ www.theMusix.net ].mp3	9.14 MiB
Jennifer Lopez - Charge Me Up (Prod. By RedOne) (Bonus Track) [ www.theMusix.net ].mp3	9.11 MiB
Gala vs. Magic System - Coco Cherie From Desire (Willy William Remix) [ www.theMusix.net ].mp3	9.1 MiB
Mumzy Stranger Ft. Junior - Mama Used To Say [ www.theMusix.net ].mp3	9.07 MiB
J.Cole - In The Morning (Feat. Drake) [ www.theMusix.net ].mp3	9.05 MiB
Skrillex - Reptile's Theme (Original Mix) [ www.theMusix.net ].mp3	9.04 MiB
The Dream - Motivation [ www.theMusix.net ].mp3	9.04 MiB
Bros Projeckt ft. Denisa - My Life [ www.theMusix.net ].mp3	9.02 MiB
T-Pain Feat. Joe Galaxy - Booty Wurk (One Cheek At A Time) (Prod. By Young Fyre) [ www.theMusix.net ].mp3	9 MiB
Durrty Goodz Feat. Inferno - Don't Ask Me [ www.theMusix.net ].mp3	8.99 MiB
Ricky Blaze - Love Right Now [ www.theMusix.net ].mp3	8.94 MiB
Rusko - Everyday [ www.theMusix.net ].mp3	8.91 MiB
Yelawolf Feat. Chamillionaire, Trae Tha Truth - Shit I've Seen (Remix) [ www.theMusix.net ].mp3	8.89 MiB
Robyn - Call Your Girlfriend (Feed Me Remix) [ www.theMusix.net ].mp3	8.88 MiB
XV - Awesome [Remix] (feat. Pusha T) [ www.theMusix.net ].mp3	8.87 MiB
Xonia feat. Deepcentral - Hold On (Radio Edit) [ www.theMusix.net ].mp3	8.86 MiB
Chrishan - Running On Empty [ www.theMusix.net ].mp3	8.81 MiB
JoJo Pellegrino feat. Chris Brown - Love [ www.theMusix.net ].mp3	8.8 MiB
Noni - Give Me The Sunlight (Radio Edit Version 2) [ www.theMusix.net ].mp3	8.79 MiB
Kelly Rowland - I'm Da Chick (Prod. By Darkchild) [ www.theMusix.net ].mp3	8.75 MiB
Sam Salter feat. Lil Wayne - 4 Ever Heartbreak [ www.theMusix.net ].mp3	8.74 MiB
Hyper Crush - Kick Us Out (DJ Frank E & R3hab Remix) [ www.theMusix.net ].mp3	8.74 MiB
Omarion Feat. Red Cafe - Battle [ www.theMusix.net ].mp3	8.73 MiB
New Boyz Ft. Charlie Wilson - Beautiful Dancer [ www.theMusix.net ].mp3	8.7 MiB
D. Brown - Round & Round [ www.theMusix.net ].mp3	8.68 MiB
Mumzy Stranger - Heartbreaker [ www.theMusix.net ].mp3	8.65 MiB
Chris Brown ft Big Sean, Timbaland - Scissors, Paper, Rock [ www.theMusix.net ].mp3	8.65 MiB
Justice Crew Ft. Flo Rida - Dance With Me [ www.theMusix.net ].mp3	8.64 MiB
Young Chris - Young Chris - Novacane (Remix) [ www.theMusix.net ].mp3	8.62 MiB
Mateo Feat. Pusha T & Ab Liva - Power [ www.theMusix.net ].mp3	8.62 MiB
Goone - Hypnotized ft. O.V. (prod. by Judge) [ www.theMusix.net ].mp3	8.6 MiB
Taio Cruz - Little Bad Girl [ www.theMusix.net ].mp3	8.57 MiB
Freddie Gibbs Feat. Young Jeezy - Run D MC (Prod. By Lil Lody) [ www.theMusix.net ].mp3	8.55 MiB
The Cataracs feat. Dev - Top of the World [ www.theMusix.net ].mp3	8.47 MiB
Lonny Bereal Ft. Kelly Rowland - Favor (CDQ) [ www.theMusix.net ].mp3	8.45 MiB
Lloyd Banks Ft. Fabolous - Perfect Match (CDQ) [ www.theMusix.net ].mp3	8.44 MiB
Wolfgang Gartner Feat. Will.I.Am - Forever [ www.theMusix.net ].mp3	8.42 MiB
Jackie Boyz Ft. Izel - Future Back [ www.theMusix.net ].mp3	8.41 MiB
Sergio - In Your Eyes (Radio Edit) [ www.theMusix.net ].mp3	8.37 MiB
Mia Taylor - My Drug [ www.theMusix.net ].mp3	8.36 MiB
Jai Alexander & Sarah - Lovers night (radio edit) [ www.theMusix.net ].mp3	8.35 MiB
Carolina Marquez - Wicked Wow (Lazy Ants Remix) [ www.theMusix.net ].mp3	8.34 MiB
Nifty Feat. U.L.A. - Sippin' (Prod. By New Hotness) [ www.theMusix.net ].mp3	8.33 MiB
Clinton Sparks Ft. LMFAO & JoJo - Sucks To Be You [ www.theMusix.net ].mp3	8.33 MiB
Britney Spears - Inside Out (Remix) (feat. Justin Garner) [ www.theMusix.net ].mp3	8.33 MiB
Pitbull feat. Ray Lavender - (Get) Naked [ www.theMusix.net ].mp3	8.33 MiB
Akon - Chasin U [ www.theMusix.net ].mp3	8.32 MiB
Akcent feat. Ruxandra Bar - Feelings On Fire (Original Radio Edit) [ www.theMusix.net ].mp3	8.3 MiB
Aziatix - Go [ www.theMusix.net ].mp3	8.3 MiB
Detail (Feat. Sean Kingston) - Hold You [ www.theMusix.net ].mp3	8.28 MiB
Claude - Famous [ www.theMusix.net ].mp3	8.26 MiB
Riz Ft. Pitbull - Dance With Me [ www.theMusix.net ].mp3	8.26 MiB
David Guetta Feat. Nicki Minaj & Flo Rida - Where Them Girls At (Final) [ www.theMusix.net ].mp3	8.18 MiB
Dawn (of Diddy Dirty Money) - Control The Lights [ www.theMusix.net ].mp3	8.18 MiB
Swedish House Mafia - Save The World [ www.theMusix.net ].mp3	8.15 MiB
Katy Perry - E.T. (Urban Noize Remix) [ www.theMusix.net ].mp3	8.13 MiB
Jay Sean - Moment To Love (Prod. By David Guetta) [ www.theMusix.net ].mp3	8.11 MiB
Rotimi Feat. Gucci Mane - Bottles [ www.theMusix.net ].mp3	8.08 MiB
Kylian Mash & Ekow Ft. Snoop Dogg - Closer [ www.theMusix.net ].mp3	8.02 MiB
Marian Vasilescu - Crush on you (Original Radio Edit) [ www.theMusix.net ].mp3	8.02 MiB
DJ Felli Fel Ft. Pitbull, Jermaine Dupri & Akon - Boomerang [ www.theMusix.net ].mp3	8.01 MiB
Pusha T - Feelin' Myself (prod. Tha Bizness) [ www.theMusix.net ].mp3	8.01 MiB
Nicole Scherizinger - Right There (50 Cent Remix) [ www.theMusix.net ].mp3	8.01 MiB
Hot Rod - Bass Down Low (Cook and Clean) Remix - Hot Rod, Cataracs and Dev [ www.theMusix.net ].mp3	7.99 MiB
Lil Wayne - Show Em What Ya Got [ www.theMusix.net ].mp3	7.96 MiB
Angelika Vee - Tokio Love (Original Radio Edit) [ www.theMusix.net ].mp3	7.95 MiB
Red Cafe - Paper Touchin Re-Remix - ft Hood, Cassidy, Stat Quo [ www.theMusix.net ].mp3	7.94 MiB
Trey Songz feat. Eminem - If I Die Tonight [ www.theMusix.net ].mp3	7.93 MiB
Dan Balan - Freedom (Original Radio Edit) [ www.theMusix.net ].mp3	7.92 MiB
Rudeboy - Don't Stop feat DJ Black Out [ www.theMusix.net ].mp3	7.91 MiB
2 Pistols Feat. Jovi Rockwell - I Love Myself [ www.theMusix.net ].mp3	7.89 MiB
Zabava Feat. Dj Jonnessey Aner - You (ScreeN & Asher Deejay Remix) [ www.theMusix.net ].mp3	7.88 MiB
Sergio Project - Mi Amor (Radio Edit) [ www.theMusix.net ].mp3	7.88 MiB
Rome - Bigger (Prod By Don Mind Productions) [ www.theMusix.net ].mp3	7.87 MiB
Bruno Mars Ft. Diggy - Click Clack Away [ www.theMusix.net ].mp3	7.84 MiB
DJ Snake Feat. Eva Simons - Pressure In The Club (Disco Fries Remix) [ www.theMusix.net ].mp3	7.84 MiB
Ty$ Feat. Fuego & Ly$$i - Get No Better (Full) [ www.theMusix.net ].mp3	7.84 MiB
Karl Wolf Feat. Kardinal Offishall - Ghetto Love (Final) [ www.theMusix.net ].mp3	7.83 MiB
David Correy ft. Chevy Woods - Fast Lane [ www.theMusix.net ].mp3	7.82 MiB
T-Pain Feat. P.L Official & B. Martin - Motivated (Prod. By YoungFyre) (Mastered+Full) [ www.theMusix.net ].mp3	7.8 MiB
Akon Feat. Pitbull & Jermaine Dupri - Boomerang (Full+NoShout) [ www.theMusix.net ].mp3	7.79 MiB
Git Fresh - Im In Control ( 2o11 ) [ www.theMusix.net ].mp3	7.77 MiB
Maino Feat. Lloyd Banks - Yes Yes Ya'll [ www.theMusix.net ].mp3	7.74 MiB
Vybz Kartel - Go Go Wine [ www.theMusix.net ].mp3	7.74 MiB
Omega Ft. Akon - El Product [ www.theMusix.net ].mp3	7.69 MiB
Lights Over Paris ft. The Game - I'm Not A Gangsta [ www.theMusix.net ].mp3	7.67 MiB
Vybz Kartel - Real Badman [ www.theMusix.net ].mp3	7.66 MiB
AMiR - Formula [ www.theMusix.net ].mp3	7.64 MiB
Ethan feat Paul Panait - Sweet Poison (Radio Edit) [ www.theMusix.net ].mp3	7.63 MiB
Lora - Fall In Love Tonight [ www.theMusix.net ].mp3	7.61 MiB
David Latour, Hi-Mode & Narco - Venus Vs Mars [ www.theMusix.net ].mp3	7.56 MiB
Clinton Sparks - She's A Pro (Prod. By Clinton Sparks & DJ Snake) [ www.theMusix.net ].mp3	7.55 MiB
Pitbull Feat. Ne-Yo & Nayer - Give Me Everything (Tonight) (Prod. By Afrojack) [ www.theMusix.net ].mp3	7.53 MiB
Nadia Ali, Starkillers & Alex Kenji - Pressure (Alesso Remix Edit) [ www.theMusix.net ].mp3	7.53 MiB
Enrique Iglesias Ft. Usher, Lil Wayne & Nayer - Dirty Dancer (Remix) [ www.theMusix.net ].mp3	7.47 MiB
Carolina Marquez - Wicked Wow (DJ Chuckie Radio Mix) [ www.theMusix.net ].mp3	7.47 MiB
Ludacris Feat. Slaughterhouse & Claret Jai - F5 (Furiously Dangerous) [ www.theMusix.net ].mp3	7.46 MiB
Afrojack - Pop On Acid [ www.theMusix.net ].mp3	7.43 MiB
RichGirl Ft. Chris Brown - For You [ www.theMusix.net ].mp3	7.42 MiB
Red Cafe - We Get It On feat Omarion (Prod by Cardiak) [ www.theMusix.net ].mp3	7.37 MiB
Blair Taylor - Cross The Border [ www.theMusix.net ].mp3	7.36 MiB
50 Cent - All His Love [ www.theMusix.net ].mp3	7.36 MiB
Michael Mind Project feat. Sean Kingston - Ready Or Not (Single Edit) [ www.theMusix.net ].mp3	7.35 MiB
Above & Beyond feat. Richard Bedford - Thing Called Love (Radio Edit) [ www.theMusix.net ].mp3	7.34 MiB
Severiano Deejay ft K - Flow Rella Roxx - Unspoken Feelings [ www.theMusix.net ].mp3	7.32 MiB
Audio ft. Akon - Magnetic (Leeyou & Danceey Remix) [ www.theMusix.net ].mp3	7.32 MiB
Eva ft Gucci Mane - Eva ft Gucci Mane - Not My Daddy (Remix) [ www.theMusix.net ].mp3	7.3 MiB
Faydee - Love Hangover [ www.theMusix.net ].mp3	7.29 MiB
DJ Alidin Feat. Fatman Scoop - Summerbreak [ www.theMusix.net ].mp3	7.29 MiB
Chrishan - Run 2 Walk Away [ www.theMusix.net ].mp3	7.29 MiB
Speak One feat. Tudor (Fly Project) & Irene - No. 1 (Original Radio Edit) [ www.theMusix.net ].mp3	7.27 MiB
Stein AKA Einstein Feat Gyptian - Take You For A Ride - Stein AKA Einstein Feat Gyptian - Take You For A Ride [ www.theMusix.net ].mp3	7.26 MiB
Rick Ross Ft. Chrisette Michele, Drake & T.I. - Aston Martin Music (Remix) [ www.theMusix.net ].mp3	7.24 MiB
Ellie White - Power Of Love [ www.theMusix.net ].mp3	7.23 MiB
Benny Benassi Ft. Clinton Sparks - Watch You [ www.theMusix.net ].mp3	7.16 MiB
Benny Benassi feat. Clinton Sparks - Watch You [ www.theMusix.net ].mp3	7.16 MiB
Avant - Leave [ www.theMusix.net ].mp3	7.14 MiB
Smiles - Santa Marinero (Radio Edit) [ www.theMusix.net ].mp3	7.07 MiB
Vybz Kartel - What Goes Up [ www.theMusix.net ].mp3	7.03 MiB
New Boyz Feat. Shanell - Can't Nobody (Prod. By Kane Beatz) [ www.theMusix.net ].mp3	6.97 MiB
Bobby V Ft. R. Kelly - Words (Remix) [ www.theMusix.net ].mp3	6.96 MiB
Chrishan Ft. Jordyn Taylor - Jump [ www.theMusix.net ].mp3	6.95 MiB
Lupe Fiasco - Break The Chain Ft. Eric Turner And Sway (Produced By iSHi) [ www.theMusix.net ].mp3	6.93 MiB
Tyga Feat. Lloyd - Real Tonight [ www.theMusix.net ].mp3	6.92 MiB
DJ Khaled Ft. Drake, Rick Ross & Lil Wayne - I'm On One [ www.theMusix.net ].mp3	6.89 MiB
J. Randall - After The Love (Prod. By Chuck Harmony) [ www.theMusix.net ].mp3	6.88 MiB
Claude - Wetta [ www.theMusix.net ].mp3	6.87 MiB
Alex Gaudino Feat. Kelly Rowland - What A Feeling [ www.theMusix.net ].mp3	6.82 MiB
Reek Da Villian Feat. Roscoe Dash, Busta Rhymes, Ace Hood, Bun B & Akon - Fall Out (Remix) [ www.theMusix.net ].mp3	6.74 MiB
T.I. Feat. Christina Aguilera - Castle Walls [ www.theMusix.net ].mp3	6.74 MiB
Jennifer Lopez - Papi [ www.theMusix.net ].mp3	6.73 MiB
Sean Paul - Gal A Bawl For Me [ www.theMusix.net ].mp3	6.72 MiB
LLoyd Banks ft. Young Jeezy - Start It Up (Remix) [ www.theMusix.net ].mp3	6.7 MiB
Nifty - On The Low [ www.theMusix.net ].mp3	6.68 MiB
Lloyd - Private Dancer (Prod. By Jim Jonsin) [ www.theMusix.net ].mp3	6.66 MiB
Jim Jones Feat. Chink Santana - The Paper [ www.theMusix.net ].mp3	6.61 MiB
The Lonely Island Feat. Santigold - After Party [ www.theMusix.net ].mp3	6.6 MiB
50 Cent ft. Drake & Quincy Jagher - Be My Girl (Scoville Mix) [ www.theMusix.net ].mp3	6.6 MiB
Pitbull - Pause [ www.theMusix.net ].mp3	6.59 MiB
Mihai Teodor - My My My (Original Radio Edit) [ www.theMusix.net ].mp3	6.56 MiB
Tinie Tempah Feat. Bei Maejor - So Addicted [ www.theMusix.net ].mp3	6.56 MiB
Ya Boy ft Gucci Mane, Gudda Gu - Cocaina [ www.theMusix.net ].mp3	6.54 MiB
Diddy Dirty & Money Feat. Trey Songz & Rick Ross - Your Love (Remix) (Mastered) [ www.theMusix.net ].mp3	6.53 MiB
Bei Maejor feat. J. Cole - Trouble [ www.theMusix.net ].mp3	6.52 MiB
Tinie Tempah Ft. Wiz Khalifa & Lyrical Eye - Till I'm Gone (Remix) [ www.theMusix.net ].mp3	6.5 MiB
Ya Boy Feat. Akon - Lock Down (Shouts) [ www.theMusix.net ].mp3	6.48 MiB
Chris Brown ft Kevin McCall, S - Spend It All [ www.theMusix.net ].mp3	6.46 MiB
Kelly Rowland ft Lil Wayne - Motivation [ www.theMusix.net ].mp3	6.44 MiB
Nicki Minaj feat. Julio & Drake - Moment 4 Life [ www.theMusix.net ].mp3	6.41 MiB
Fuego Feat. Ty$ & Lyssi - Get No Better [ www.theMusix.net ].mp3	6.39 MiB
Jason Derulo - Don't Wanna Go Home [ www.theMusix.net ].mp3	6.38 MiB
Game Feat. Trey Songz - She Wanna Have My Baby [ www.theMusix.net ].mp3	6.37 MiB
Akon - Just a Man [ www.theMusix.net ].mp3	6.35 MiB
Mason Feat. Sway - I Just Wanna Rock You [ www.theMusix.net ].mp3	6.35 MiB
RL (of Next) - My Baby Girl [ www.theMusix.net ].mp3	6.35 MiB
Ike Nice - Around The World [ www.theMusix.net ].mp3	6.31 MiB
Sahara Feat. Shaggy - Champagne (Final) [ www.theMusix.net ].mp3	6.29 MiB
The Lonely Island Ft. Snoop Dogg - Turtleneck & Chain [ www.theMusix.net ].mp3	6.28 MiB
Ke$ha Feat. B.o.B - Blow (Remix) [ www.theMusix.net ].mp3	6.26 MiB
Day26 - Imma Put It On Her (Capo Decina Remix) [ www.theMusix.net ].mp3	6.21 MiB
Jack Beats - Elevator Music [ www.theMusix.net ].mp3	6.21 MiB
Ester Dean - Take You To Rio [ www.theMusix.net ].mp3	6.2 MiB
Demarco - Dat Me Say [ www.theMusix.net ].mp3	6.19 MiB
Cheap Thrills - Dont Stop The Party (Mister Gray Peak Overhaul) [ www.theMusix.net ].mp3	6.16 MiB
Karl Wolf - Superstar [ www.theMusix.net ].mp3	6.14 MiB
DJ Snake feat. Eva Simons - Pressure in the Club [ www.theMusix.net ].mp3	6.13 MiB
Madcon - Throw Me To The Wind (Prod. By Stargate) [ www.theMusix.net ].mp3	6.13 MiB
Jay Sean ft Tyga, Busta Rhymes, Cory Gunz - YMCMB Heroes - YMCMB Heroes [ www.theMusix.net ].mp3	6.12 MiB
Usher ft. Pitbull - Dj Got Us Falling In Love Again (DJ Casanova Remix) [ www.theMusix.net ].mp3	6.11 MiB
Pete Miles - Angels and Demons Dubstep Mix [ www.theMusix.net ].mp3	6.11 MiB
Far East Movement feat. Natalia Kills & Ya Boy - 2 Is Better [ www.theMusix.net ].mp3	6.1 MiB
New Boyz - Let U Leave (Prod. By Jay Nari) (Final) [ www.theMusix.net ].mp3	6.1 MiB
Eminem & Royce Da 5'9 Feat. Chamillionaire - Fast Lane (Remix) [ www.theMusix.net ].mp3	6.09 MiB
Ryan Tedder - The World I Knew [ www.theMusix.net ].mp3	6.07 MiB
DJ Drama Ft. Fabolous, Roscoe Dash & Wiz Khalifa - Oh My [ www.theMusix.net ].mp3	6.05 MiB
American Yard - W.I.R.E.D [ www.theMusix.net ].mp3	6.04 MiB
Trina - Trina - Hit It Right (No Shout) [ www.theMusix.net ].mp3	6.02 MiB
DJ Robert Georgescu feat. Annamari Dancs - A-Ha Oneira (Dj Soler Edit Extended) [ www.theMusix.net ].mp3	6.02 MiB
Kelly Rowland feat. Lil Wayne - Motivation (Club Mix) [ www.theMusix.net ].mp3	6.01 MiB
One Chance Ft. Lu Jerz - To The Middle [ www.theMusix.net ].mp3	6.01 MiB
Birdman Feat. T-Pain, Mack Maine, & Lil Wayne - Get Money (Prod. By The Runners) [ www.theMusix.net ].mp3	6.01 MiB
Bei Maejor - Racks On Racks (Piano Remix) [ www.theMusix.net ].mp3	6 MiB
Charlie Ward Feat. Flo-Rida - I Wanna (Mastered) [ www.theMusix.net ].mp3	5.99 MiB
J Blue - Bye Bye Bye [ www.theMusix.net ].mp3	5.97 MiB
Brandy - So Cold [ www.theMusix.net ].mp3	5.94 MiB
Nifty - Stick Up (Prod. By New Hotness) [ www.theMusix.net ].mp3	5.92 MiB
Charice - One Day [ www.theMusix.net ].mp3	5.92 MiB
Nifty - So Tell em (Prod. By New Hotness) [ www.theMusix.net ].mp3	5.9 MiB
Nifty - So Tell 'Em (Prod. by New Hotness) [ www.theMusix.net ].mp3	5.9 MiB
Gemini - Blue [ www.theMusix.net ].mp3	5.86 MiB
Notch - Chat [ www.theMusix.net ].mp3	5.85 MiB
Antonio Carmona feat. Nelly Furtado - El Camino de los Suenos [ www.theMusix.net ].mp3	5.85 MiB
Eve - Nothing To Say (Prod. By Timbaland) [ www.theMusix.net ].mp3	5.84 MiB
T-Pain Ft. Young Cash - Top Flight Sex (Of The World) [ www.theMusix.net ].mp3	5.84 MiB
Ben Ready Feat. Travis Porter & JR Get Money - All In Her Mouth [ www.theMusix.net ].mp3	5.81 MiB
Mac Miller ft Wiz Khalifa - Keep Floatin [ www.theMusix.net ].mp3	5.81 MiB
LB The Hype Feat. Audio Push - Dip Down [ www.theMusix.net ].mp3	5.8 MiB
Mateo Amarei - That Girl [ www.theMusix.net ].mp3	5.78 MiB
Iyaz Ft. Travie McCoy - Pretty Girls [ www.theMusix.net ].mp3	5.75 MiB
Chris Medina - What Are Words [ www.theMusix.net ].mp3	5.73 MiB
Lumidee Ft. Beenie Man - Celebration [ www.theMusix.net ].mp3	5.73 MiB
Kelly Rowland - Can't Escape (Shout) [ www.theMusix.net ].mp3	5.73 MiB
JC - Motion Picture [ www.theMusix.net ].mp3	5.7 MiB
Timbaland feat. Brandy, James Fauntleroy & 'Ryan Aver - 808 (FINAL) [ www.theMusix.net ].mp3	5.7 MiB
David No Fuck feat. Vnalogic - La Cocaina (Radio Edit) [ www.theMusix.net ].mp3	5.7 MiB
The Suppliers - I Got Doe [ www.theMusix.net ].mp3	5.69 MiB
Detail - Dont Stop Now [ www.theMusix.net ].mp3	5.67 MiB
YC Feat. Yung Joc Nephew & Supplier - Fucking Around Like This (Full+NoShout) [ www.theMusix.net ].mp3	5.67 MiB
Mischke - Broken [ www.theMusix.net ].mp3	5.65 MiB
Cashis Feat. K-Young - The Life [ www.theMusix.net ].mp3	5.65 MiB
Drag-On ft Cassidy, AR-AB, Ter - Metal Spray [ www.theMusix.net ].mp3	5.63 MiB
Sean Garrett Ft. Rick Ross - In Da Box (Mastered) [ www.theMusix.net ].mp3	5.63 MiB
Jean Grae - R.I.P. (Feat. Styles P & Talib Kweli) (Prod By Ski Beatz) [ www.theMusix.net ].mp3	5.63 MiB
Flo Rida feat. Akon - Who Dat Girl (Club Mix) [ www.theMusix.net ].mp3	5.63 MiB
Make It Rain (DJ Mike D T-Mix Uptempo) - Travis Porter Feat. T-Pain [ www.theMusix.net ].mp3	5.62 MiB
Jeremih - Jeremih - Look At Me Now (Remix) [ www.theMusix.net ].mp3	5.54 MiB
Chingy - Superhero [ www.theMusix.net ].mp3	5.52 MiB
RacQ Dolo Feat. Fred The Godson - Like A Bomb [ www.theMusix.net ].mp3	5.5 MiB
The Cataracs Ft. Dev - Turnt 4 Da Weekend [ www.theMusix.net ].mp3	5.5 MiB
Snoop Dogg - I Don't Need No Bitch (Feat. Devin the Dude & Kobe Honeycutt) [ www.theMusix.net ].mp3	5.49 MiB
Snoop Dogg - I Don't Need No Bitch (Feat. Devin The Dude & Kobe) [ www.theMusix.net ].mp3	5.49 MiB
Hot Rod - Dance With Me (Chew Fu Remix) [ www.theMusix.net ].mp3	5.49 MiB
G4 Boyz Ft. Lil Wayne - I Do Me [ www.theMusix.net ].mp3	5.48 MiB
Diddy Dirty Money Ft. Trey Songz & Rick Ross - Your Love (Remix) [ www.theMusix.net ].mp3	5.48 MiB
The Dream - Hello, Hi Goodbye [ www.theMusix.net ].mp3	5.46 MiB
American Yard - Radio [ www.theMusix.net ].mp3	5.46 MiB
Alley Boy Feat. Trey Songz - When I Ride [ www.theMusix.net ].mp3	5.45 MiB
Black Buddafly - Rain All Night [ www.theMusix.net ].mp3	5.45 MiB
Jean-Roch Ft. Flo Rida & Kat Deluna - I'm Alright (Radio Rip) [ www.theMusix.net ].mp3	5.44 MiB
Britney Spears feat. Nicki Minaj & Kesha - Till The World Ends [ www.theMusix.net ].mp3	5.43 MiB
Snoop Dogg - El Lay (Feat. Marty James) [ www.theMusix.net ].mp3	5.43 MiB
Erin Christine - Naked (remix) ft. XV [ www.theMusix.net ].mp3	5.41 MiB
Fabolous Feat. Ne-Yo & Ryan Leslie - Look At Her (Killin Em Part 2) [ www.theMusix.net ].mp3	5.4 MiB
Mohombi - Fade Away [ www.theMusix.net ].mp3	5.4 MiB
Dev - Dancing In The Dark [ www.theMusix.net ].mp3	5.39 MiB
French Montana Ft. Gucci Mane & Wiz Khalifa - Choppa Choppa Down (Remix) [ www.theMusix.net ].mp3	5.38 MiB
Enrique Iglesias ft. Ludacris - Tonight [ www.theMusix.net ].mp3	5.36 MiB
Bobby V - Hummin ft. Lloyd Banks [ www.theMusix.net ].mp3	5.35 MiB
Bueno Feat. Lil' Eddie - Dat Good (Prod. By The Stereotypes) [ www.theMusix.net ].mp3	5.34 MiB
Supa Show - Pressure (Prod. By J.U.S.T.I.C.E. League) [ www.theMusix.net ].mp3	5.34 MiB
XV Feat. Pusha T - Awesome [ www.theMusix.net ].mp3	5.33 MiB
Lil Eddie - Man On Fire [ www.theMusix.net ].mp3	5.32 MiB
DMX - Get Your Money Up [ www.theMusix.net ].mp3	5.31 MiB
Wiz Khalifa Feat. Vybz Kartel - Roll Up (Remix) [ www.theMusix.net ].mp3	5.3 MiB
Adele Ft. Gilbere Forte' - Set Fire To The Rain (Remix) [ www.theMusix.net ].mp3	5.3 MiB
Katy Perry Feat. Kanye West - E.T. (Prod. By Max Martin) [ www.theMusix.net ].mp3	5.29 MiB
Snoop Dogg Feat. T-Pain - Boom (Prod. By Scott Storch) ( 2o11 ) [ www.theMusix.net ].mp3	5.28 MiB
Snoop Dogg Feat. T-Pain - Boom (Prod. By Scott Storch) [ www.theMusix.net ].mp3	5.28 MiB
Ciara - Gifted [ www.theMusix.net ].mp3	5.28 MiB
Marcus Manchild Feat. Bun B, Chamillionaire, Slim Thug, Paul Wall & Kirko Bangz - Get Off Me (Remix) [ www.theMusix.net ].mp3	5.27 MiB
Jadakiss Feat. Akon Murda Mook & Shella - Freaky (Mastered) (Prod. By Qdizzy) [ www.theMusix.net ].mp3	5.26 MiB
Jadakiss Feat. Akon Murda Mook & Shella - Freaky (Mastered) [ www.theMusix.net ].mp3	5.26 MiB
Ironik Ft. Kaley - Be There For Me [ www.theMusix.net ].mp3	5.25 MiB
Wiz Khalifa - Wake Up (Prod. By Stargate) [ www.theMusix.net ].mp3	5.22 MiB
Untitled Ft. Kardinal Offishall - Island Girl [ www.theMusix.net ].mp3	5.21 MiB
David Guetta Ft Nicki Minaj, Flo-Rida - Where Dem Girls At [ www.theMusix.net ].mp3	5.21 MiB
Chris Brown Ft. Jeremy Greene - Beautiful People (Remix) [ www.theMusix.net ].mp3	5.21 MiB
Anthem Kingz - Bumpy Heartbreak [ www.theMusix.net ].mp3	5.19 MiB
Tydolla$ign - All Star (Dirty) [ www.theMusix.net ].mp3	5.19 MiB
Jim Jones Ft. Juelz Santana & Waka Flocka Flame - 848 [ www.theMusix.net ].mp3	5.17 MiB
Nate Evans - Are You Ready (Prod. by G&J) [ www.theMusix.net ].mp3	5.17 MiB
Lil Wayne Ft. Mack Maine & Kidd Kidd - She Bad [ www.theMusix.net ].mp3	5.14 MiB
Akon ft. Ludacris and Lil Jon - Drop Down (DJ Frankee and DJ OGB Remix) [ www.theMusix.net ].mp3	5.14 MiB
Ant Matos - Laser Tag [ www.theMusix.net ].mp3	5.11 MiB
Cherlise feat. Rico Love - All Night Love [ www.theMusix.net ].mp3	5.1 MiB
Vybz Kartel - Horny & Proud (White Liver) [ www.theMusix.net ].mp3	5.1 MiB
R. Kelly Feat. Juvenile - Rodeo Show (Full+NoShout) [ www.theMusix.net ].mp3	5.09 MiB
Atozzio - Hold You Down [ www.theMusix.net ].mp3	5.08 MiB
Mac Miller - All Around The World (Prod By_ Just Blaze) [ www.theMusix.net ].mp3	5.08 MiB
Shawty Lo Feat. Twista & Wale - Pocahontas (Shouts) [ www.theMusix.net ].mp3	5.08 MiB
T.I. - Celebrate [ www.theMusix.net ].mp3	5.07 MiB
Lil Wayne Ft. Gudda Gudda - That's What They Call [ www.theMusix.net ].mp3	5.07 MiB
Chrishan - Never Let Me Down (Prod. By Hitimpulse) [ www.theMusix.net ].mp3	5.07 MiB
Keyshia Cole Feat. Gucci Mane & Nicki Minaj - I Aint Thru [ www.theMusix.net ].mp3	5.06 MiB
Berner Ft. Wiz Khalifa & Big K.R.I.T. - Yoko [ www.theMusix.net ].mp3	5.05 MiB
Akon Feat. Chris Brown - Take It Down Low (Prod. By Polow Da Don) [ www.theMusix.net ].mp3	5.05 MiB
Carl Henry Feat. Vado - All That I Know (Final) [ www.theMusix.net ].mp3	5.04 MiB
Timati Feat. Eve - Money In Da Bank [ www.theMusix.net ].mp3	5.04 MiB
Daz Dillinger Feat. Snoop Dogg - Set It Off [ www.theMusix.net ].mp3	5.03 MiB
French Montana Ft. Rick Ross & Wiz Khalifa - Choppa Choppa Down (Remix) [ www.theMusix.net ].mp3	5.03 MiB
Ja Rule - Real Life Fantasy [ www.theMusix.net ].mp3	5.02 MiB
American Yard - Maranello 8 [ www.theMusix.net ].mp3	5.01 MiB
Eminem - The Apple [ www.theMusix.net ].mp3	4.99 MiB
Taio Cruz - Believe In Me Now (Prod. By Swedish House Mafia) [ www.theMusix.net ].mp3	4.99 MiB
Tinie Tempah Ft. Rick Ross & Lil Wayne - Hustle Hard (Remix) [ www.theMusix.net ].mp3	4.96 MiB
Eminem Ft. Slaughterhouse & Yelawolf - 2.0 Boys [ www.theMusix.net ].mp3	4.96 MiB
Cobra Starship Feat. Sabi - You Make Me Feel [ www.theMusix.net ].mp3	4.96 MiB
Pitbull - Rock The Boat [ www.theMusix.net ].mp3	4.95 MiB
Natalia Kills - Mirrors (Chris Moody Remix) [ www.theMusix.net ].mp3	4.95 MiB
Drake - Dreams Money Can Buy [ www.theMusix.net ].mp3	4.93 MiB
Max B - Money Makes Me Feel Better [ www.theMusix.net ].mp3	4.91 MiB
Taio Cruz - Telling The World [ www.theMusix.net ].mp3	4.9 MiB
Lil Kee Feat. Strizzo & Javon Black - She Go Live [ www.theMusix.net ].mp3	4.9 MiB
TC - Fighting 4 Your... [ www.theMusix.net ].mp3	4.88 MiB
Aylen_The Black Eyed Peas - Just Can t Get Enough Aylen Remix [ www.theMusix.net ].mp3	4.88 MiB
Lil Kim ft Wiz Khalifa - Lil Kim ft Wiz Khalifa - Champagne Poppin [ www.theMusix.net ].mp3	4.87 MiB
DJ K-MATIC Feat. GhostWridah & Fly Boi - Summer In Miami [ www.theMusix.net ].mp3	4.85 MiB
New Boyz Feat. The Cataracs & Dev - BackSeat (Remix) [ www.theMusix.net ].mp3	4.85 MiB
YG ft Tyga, Nipsey Hussle - YG ft Tyga, Nipsey Hussle - Bitches Aint Shit [ www.theMusix.net ].mp3	4.84 MiB
Bertell Feat. T-Pain & Bow Wow - Headboard (Part 2) (NoShout) [ www.theMusix.net ].mp3	4.78 MiB
Romeo Ft. Sean Kingston - Famous Girl [ www.theMusix.net ].mp3	4.78 MiB
Entranjj Feat. Lil Wayne - I Own It [ www.theMusix.net ].mp3	4.77 MiB
Chrishan - Drinks In The Air [ www.theMusix.net ].mp3	4.77 MiB
Elijah King feat. T-Pain & Young Cash - Handclap (Dance Mix) [ www.theMusix.net ].mp3	4.75 MiB
Ray J - Yesterday feat The Game [No DJ] [ www.theMusix.net ].mp3	4.74 MiB
Chamillionaire - When Ya On (Feat. Nipsey Hussle) [ www.theMusix.net ].mp3	4.73 MiB
Tino Cochino - Tonight Is The Night (Prod. By ReesePiece) [ www.theMusix.net ].mp3	4.72 MiB
K. Drew ft. Gucci Mane - Bedroom (CDQ) [ www.theMusix.net ].mp3	4.72 MiB
Ty$ Feat. Will.I.Am - Next 2 You (Shouts) [ www.theMusix.net ].mp3	4.72 MiB
Atozzio Ft. Tynisha Keli - Reasons [ www.theMusix.net ].mp3	4.7 MiB
Lloyd - Don't You Wanna Know (Prod. by Streetlove) [ www.theMusix.net ].mp3	4.7 MiB
Kid Ink - Let It Go (Prod by Famous) [ www.theMusix.net ].mp3	4.69 MiB
Jeremih feat. Kelly Rowland & Lil Wayne - Motivation [ www.theMusix.net ].mp3	4.69 MiB
Fabolous Feat. Lil Wayne - That's Not Love [ www.theMusix.net ].mp3	4.66 MiB
Yung Berg Feat. Ray J - After The Club [ www.theMusix.net ].mp3	4.65 MiB
Yung Berg Feat. Ray J - After The Club (NoShout) [ www.theMusix.net ].mp3	4.65 MiB
T-Jay - Mr. Doctor [ www.theMusix.net ].mp3	4.64 MiB
Kat Deluna - Drop It Low [ www.theMusix.net ].mp3	4.64 MiB
Jennifer Lopez - Invading My Mind (Prod. By RedOne) [ www.theMusix.net ].mp3	4.63 MiB
Jeremy Greene - Fallen [ www.theMusix.net ].mp3	4.62 MiB
Game Ft. Yelawolf - Rough [ www.theMusix.net ].mp3	4.61 MiB
Cam'ron Feat. Sen City, Vado, & Jim Jones - Ooohhh [ www.theMusix.net ].mp3	4.6 MiB
Young Jeezy Feat. Lil Wayne - Ballin (Prod. By Lil Lody) (Full+Mastered) [ www.theMusix.net ].mp3	4.59 MiB
Trey Songz - Shoulda Been A Rapper [ www.theMusix.net ].mp3	4.58 MiB
Jeremih - I'm On It Feat Fella [ www.theMusix.net ].mp3	4.57 MiB
Mims Feat. T.R.D. - Dangerous [ www.theMusix.net ].mp3	4.57 MiB
Jackie Boyz - Lighthouse [ www.theMusix.net ].mp3	4.57 MiB
Travis Barker - Raw Shit (featuring Tech N9ne & Bun B) [ www.theMusix.net ].mp3	4.56 MiB
Rihanna feat. Guyana - Whats My Name [ www.theMusix.net ].mp3	4.56 MiB
Rico Love - Number 1 (Prod. By Jim Jonsin) [ www.theMusix.net ].mp3	4.55 MiB
Nipsey Hussle - Tha Mansion [ www.theMusix.net ].mp3	4.54 MiB
Lil Eddie - Sexy Psycho [ www.theMusix.net ].mp3	4.54 MiB
Eminem - Can't Back Down (Ft. Drake & 50 Cent) [ www.theMusix.net ].mp3	4.53 MiB
RaVaughn - Band Aid [ www.theMusix.net ].mp3	4.5 MiB
Kevin Cossom - Black and Yellow (Remix) [ www.theMusix.net ].mp3	4.49 MiB
Nick Cannon - Nick Cannon - Famous (Feat. Akon) [ www.theMusix.net ].mp3	4.48 MiB
Dr. Dre ft Swizz Beatz - Chillin [ www.theMusix.net ].mp3	4.45 MiB
DJ Webstar Ft. Twista & Olivia - Behind Closed Doors [ www.theMusix.net ].mp3	4.45 MiB
Lil Eddie - You Should Be With Me [ www.theMusix.net ].mp3	4.45 MiB
Nik & Jay - Your Body (Wrote This Song) (Prod. By Nexus Music) [ www.theMusix.net ].mp3	4.44 MiB
Chris Brown - Talk Ya Ear Off [ www.theMusix.net ].mp3	4.43 MiB
Maino Ft. Trina & T-Pain - Ghetto (Remix) [ www.theMusix.net ].mp3	4.42 MiB
Hones-T - Bang Em In The Face feat Gudda Gudda, Boogz Boogetz & Milli Millz (Prod by Cooarri) [ www.theMusix.net ].mp3	4.41 MiB
Audio Push Feat. Chili Chil - No Love [ www.theMusix.net ].mp3	4.41 MiB
Ne Yo - Give Me Everything [ www.theMusix.net ].mp3	4.38 MiB
Kevin Cossom - Racks (Remix) [ www.theMusix.net ].mp3	4.38 MiB
Delyno ft. LooLoo - Private Love (Radio Edit) [ www.theMusix.net ].mp3	4.37 MiB
T-Jay - Step It Up [ www.theMusix.net ].mp3	4.37 MiB
Chris Brown - Oh My Love [ www.theMusix.net ].mp3	4.36 MiB
Sean Kingston Feat. Akon - You Girl (Shouts) [ www.theMusix.net ].mp3	4.35 MiB
Ty$ Feat. Kid Ink - All Star (Remix) [ www.theMusix.net ].mp3	4.35 MiB
Flo Rida Feat. Rock City - Roll Around (Prod. By Jean Bapiste) [ www.theMusix.net ].mp3	4.34 MiB
Taio Cruz - Get It Back (No Tags) [ www.theMusix.net ].mp3	4.33 MiB
Daz Dillinger ft Ice Cube - Daz Dillinger ft Ice Cube - Iz U Ready 2 Die [ www.theMusix.net ].mp3	4.33 MiB
Flo Rida Feat. Pitbull - Turn Around (Part. 2) (NoShout) [ www.theMusix.net ].mp3	4.32 MiB
Swizz Beatz Feat. Alicia Keys - It's You [ www.theMusix.net ].mp3	4.32 MiB
Audio Push Feat. Eric Bellringer - Tonight [ www.theMusix.net ].mp3	4.31 MiB
TC Feat. Deonte - Black Heart [ www.theMusix.net ].mp3	4.3 MiB
YC Feat. Yung Joc & Nephew - Fucking Around [ www.theMusix.net ].mp3	4.3 MiB
Chrishan - I Love You [ www.theMusix.net ].mp3	4.29 MiB
Boogie Breeze - Turned Up (Prod. by Leeyou & Danceey) [ www.theMusix.net ].mp3	4.28 MiB
Soulja Boy - Zan With That Lean [ www.theMusix.net ].mp3	4.26 MiB
Claude - Champion [ www.theMusix.net ].mp3	4.26 MiB
David Guetta Feat. RaVaughn Brown - Love Machine [ www.theMusix.net ].mp3	4.23 MiB
Ester Dean - Lose Control [ www.theMusix.net ].mp3	4.23 MiB
Chrishan & Kyle Christopher - Wavelength (feat. Katy Perry & D.R.) [ www.theMusix.net ].mp3	4.22 MiB
Chrishan Ft. Janel & M.I.O - Gon Under [ www.theMusix.net ].mp3	4.21 MiB
Crice Cartier Feat. Kevin Cossom - Change Your Mind [ www.theMusix.net ].mp3	4.16 MiB
TC - Take It Back (Prod. By Oak) [ www.theMusix.net ].mp3	4.15 MiB
Big Sean - I Do It (Prod. By No ID & The Legendary Traxster) [ www.theMusix.net ].mp3	4.14 MiB
Ne-Yo - Your A Star [ www.theMusix.net ].mp3	4.1 MiB
Tank Ft. Chris Brown & Trey Songz - Celebration (Remix) [ www.theMusix.net ].mp3	4.1 MiB
Ya Boy - Turn You On feat Dubb [ www.theMusix.net ].mp3	4.06 MiB
Claude - Best I Never Had [ www.theMusix.net ].mp3	4.03 MiB
Mickey Factz & Chris Brown - Beautiful People [ www.theMusix.net ].mp3	4.03 MiB
Mumzy Stranger feat. Junior - Mama Used To Say (House Version) [ www.theMusix.net ].mp3	4.02 MiB
Rusko - Everyday (Netsky Remix) [ www.theMusix.net ].mp3	4.01 MiB
Shamar Forte - Echo [ www.theMusix.net ].mp3	3.98 MiB
Robbie Casablanca - Hello Forever [ www.theMusix.net ].mp3	3.98 MiB
Papoose Feat. Lloyd Banks & Busta Rhymes - Party Bout To Pop [ www.theMusix.net ].mp3	3.97 MiB
Rico Love - Lovers [ www.theMusix.net ].mp3	3.97 MiB
Git Fresh - Whip My Dreads [ www.theMusix.net ].mp3	3.96 MiB
Fabolous ft Red Cafe - Yall Don't Hear Me Tho [ www.theMusix.net ].mp3	3.96 MiB
ShowOff & AvestarLJ - Definition of a Ratchet ft. Shorty Mack [ www.theMusix.net ].mp3	3.92 MiB
Jennifer Lopez - What Is Love (Reggaeton Remix) [ www.theMusix.net ].mp3	3.92 MiB
Maino Ft. Lloyd Banks - Anti Freeze [ www.theMusix.net ].mp3	3.91 MiB
Kevon Ross - Winner [ www.theMusix.net ].mp3	3.9 MiB
Ray J ft Kid Ink - Drinks In The Air [ www.theMusix.net ].mp3	3.89 MiB
Kevin Cossom - Racks On Racks [ www.theMusix.net ].mp3	3.88 MiB
Guyana Feat. Sean Kingston - Hands High [ www.theMusix.net ].mp3	3.85 MiB
Ironik - Soul Mate [ www.theMusix.net ].mp3	3.85 MiB
Timbaland Ft. Chris Brown - Naked [ www.theMusix.net ].mp3	3.84 MiB
Vybz Kartel - Summer Time [ www.theMusix.net ].mp3	3.84 MiB
Jahmiel - Jahmiel - What About The Love [ www.theMusix.net ].mp3	3.82 MiB
MarQ Markuz - Secret Lover [E-Motion-L Prod.] [ www.theMusix.net ].mp3	3.8 MiB
N.O.R.E. Feat. Masspike Miles - Something That's [ www.theMusix.net ].mp3	3.75 MiB
Flip Major ft. Ty$ - I Am [ www.theMusix.net ].mp3	3.72 MiB
Atozzio - Beat My Drum [ www.theMusix.net ].mp3	3.69 MiB
Range Feat. Wale - Beautiful You Are [ www.theMusix.net ].mp3	3.69 MiB
Far East Movement Ft. Koda Kumi - Make It Bump [ www.theMusix.net ].mp3	3.69 MiB
Sammie Ft. Tyga - Tonight [ www.theMusix.net ].mp3	3.69 MiB
Unknown - Homesick (2011) [ www.theMusix.net ].mp3	3.68 MiB
Chris Brown - Fools With You [ www.theMusix.net ].mp3	3.67 MiB
Lupe Fiasco - Stero Sun Feat. Eric Turner (Full) [ www.theMusix.net ].mp3	3.65 MiB
Marvell Ft. Sneakbo & A.L - Self Motivated (Prod. by Double A) [ www.theMusix.net ].mp3	3.64 MiB
Mac Miller Ft. Wale - So What [ www.theMusix.net ].mp3	3.64 MiB
Chris Brown - She Can Get It [ www.theMusix.net ].mp3	3.63 MiB
Wejeileh - One 4 Me [ www.theMusix.net ].mp3	3.63 MiB
Ludacris Ft. Untitled - Pour Out A Lil Liquor [ www.theMusix.net ].mp3	3.62 MiB
Akon - Love Handles (Prod. by David Guetta & Afrojack) [ www.theMusix.net ].mp3	3.61 MiB
Akon - Love Handles [ www.theMusix.net ].mp3	3.61 MiB
Chamillionaire - War To Your Door [ www.theMusix.net ].mp3	3.59 MiB
C-Note - Mary Go Round [ www.theMusix.net ].mp3	3.57 MiB
T.y.S & Alex B - Lento 2 (Version RnB) [ www.theMusix.net ].mp3	3.55 MiB
Stevie Hoang - Nobody [ www.theMusix.net ].mp3	3.52 MiB
Bruno Mars feat. Claude - Girl I Wait [ www.theMusix.net ].mp3	3.51 MiB
Chris Brown - Treading Water [ www.theMusix.net ].mp3	3.49 MiB
DonnellShawn - Body Blow (NoShout) [ www.theMusix.net ].mp3	3.46 MiB
Dj Idsa Big Ali And Cheb Akil - Hit The Rai Floor [ www.theMusix.net ].mp3	3.42 MiB
Shakira feat. Pitbull - Rabiosa (English Version) [ www.theMusix.net ].mp3	3.39 MiB
New Boyz Ft. Chris Brown - Better With The Lights Off [ www.theMusix.net ].mp3	3.38 MiB
Jadakiss Ft. Styles P & Chynk Show - Lay Em Down [ www.theMusix.net ].mp3	3.31 MiB
Dominic - She Has My Heart [ www.theMusix.net ].mp3	3.3 MiB
Too Short Feat. Lil Jon - Shake That Monkey (Remix) [ www.theMusix.net ].mp3	3.3 MiB
Eminem - 50 Ways [ www.theMusix.net ].mp3	3.27 MiB
Tinie Tempah Ft. Wiz Khalifa - Till I'm Gone [ www.theMusix.net ].mp3	3.27 MiB
Akon - Burn That Bridge [ www.theMusix.net ].mp3	3.26 MiB
Dan Balan - Justify Sex [ www.theMusix.net ].mp3	3.25 MiB
J Randall - Still Here [ www.theMusix.net ].mp3	3.25 MiB
Play-N-Skillz - Go Down [ www.theMusix.net ].mp3	3.24 MiB
Chamillionaire - Think About It [ www.theMusix.net ].mp3	3.22 MiB
Jason Derulo - Don't Wanna Go Home (Mastered) [ www.theMusix.net ].mp3	3.22 MiB
Kevin McCall - Ready 2 Ride [ www.theMusix.net ].mp3	3.18 MiB
Owl City Feat. B.o.B. - Alligator Sky [ www.theMusix.net ].mp3	3.18 MiB
Will.I.Am Feat. Jamie Foxx - Hot Wings (I Wanna Party) [ www.theMusix.net ].mp3	3.17 MiB
Masspike Miles - Masspike Miles - Little Soldier [ www.theMusix.net ].mp3	3.11 MiB
Lil Eddie - Best Years Of Our Life [ www.theMusix.net ].mp3	3.1 MiB
50 Cent - Bullshit & Party [ www.theMusix.net ].mp3	3.1 MiB
Young Chris Feat. Rico Love - Ooh Ahh [ www.theMusix.net ].mp3	3.09 MiB
T Lopez Feat. Lil Wayne - Breathe [ www.theMusix.net ].mp3	2.94 MiB
Mann Feat. Iyaz & Snoop Dogg - The Mack [ www.theMusix.net ].mp3	2.92 MiB
Swizz Beatz Feat. Eve - Swizz Beatz Feat. Eve - Everyday (Coolin') (Dirty) [ www.theMusix.net ].mp3	2.85 MiB
T.I. - Friday Night [ www.theMusix.net ].mp3	2.82 MiB
Tyga Feat. Chris Richardson - Far Away [ www.theMusix.net ].mp3	2.79 MiB
Maino - Faded (Remix) [ www.theMusix.net ].mp3	2.71 MiB
50 Cent - Keep it Coming [ www.theMusix.net ].mp3	2.61 MiB
Tinie Tempah - Racks On Racks (Remix) [ www.theMusix.net ].mp3	2.48 MiB
Tinie Tempah Ft. Lil Wayne - Look At Me Now (Remix) [ www.theMusix.net ].mp3	2.42 MiB
Shaggy - Wave (The Party vibe Riddim) [ www.theMusix.net ].mp3	2.26 MiB
Qwote Feat. DJ Laz - Sexy Diva (Prod. By DJ Laz) [ www.theMusix.net ].mp3	2.22 MiB
