TÃTULO ORIGINAL 	Before Sunrise
AÃ‘O 	
1995 	
DURACIÃ“N 	
101 min. 	  Trailers/VÃ­deos
PAÃS 	
[Estados Unidos] 	  SecciÃ³n visual
DIRECTOR 	Richard Linklater
GUIÃ“N 	Richard Linklater & Kim Krizan
MÃšSICA 	Fred Frith
FOTOGRAFÃA 	Lee Daniel
REPARTO 	Ethan Hawke, Julie Delpy
PRODUCTORA 	Castle Rock Entertainment presents a Detour Filmproduction / F.I.L.M.H.A.U.S Wiena Production
PREMIOS 	1995: BerlÃ­n: Oso de plata mejor director
GÃ‰NERO 	Romance. Drama | Drama romÃ¡ntico. Cine independiente USA
SINOPSIS 	Un joven periodista norteamericano (que acaba de romper con su novia) y una estudiante francesa se conocen casualmente en el tren Budapest-ParÃ­s, entablan conversaciÃ³n y deciden recorrer Viena juntos. (FILMAFFINITY)

CRÃTICAS 	----------------------------------------
Chico americano conoce chica europea. Al dÃ­a siguiente Ã©l regresa a los Estados Unidos pero, ante la duda de quÃ© hubiera pasado si tuvieran mÃ¡s tiempo para conocerse, ambos deciden pasar una romÃ¡ntica noche por Viena, hablando de la vida y de un futuro que no compartirÃ¡n... o a lo mejor sÃ­. Una bonita pelÃ­cula, de sencillo pero cautivador guiÃ³n, ideal para corazones inquietos. (Pablo Kurt: FILMAFFINITY)
----------------------------------------
"Una noche de romanticismo juvenil de paseo por Viena. Muy bien escrita por Linklater (...) Muy buena" (Javier OcaÃ±a: CinemanÃ­a)
----------------------------