The Birth of a Nation (1915) [DVDrip captions] TNT Village

.: Release Originale :.
 
http://forum.tntvillage.scambioetico.org/tntforum/index.php?showtopic=69631

.: Plot :.

Two brothers, Phil and Ted Stoneman, visit their friends in Piedmont, South Carolina: the family Cameron. This friendship is affected by the Civil War, as the Stonemans and the Camerons must join up opposite armies. The consequences of the War in their lives are shown in connection to major historical events, like the development of the Civil War itself, Lincoln's assassination, and the birth of the Ku Klux Klan. 

.: Trama :.

Il film Ã¨ una apologia della segregazione, di cui tenta di fornire radici e giustificazioni storiche. Si inserisce nel movimento culturale che portÃ² all'ascesa del Ku Klux Klan, arrivando a dipingere in modo positivo il linciaggio di un nero da parte di una folla di bianchi.

.: Cover :.
 
http://img238.imageshack.us/img238/9340/nascitaoc1.jpg

.: Crediti :.

Titolo: Nascita di una nazione
Titolo originale: The Birth of a Nation
NazionalitÃ : USA
Anno: 1915
Genere: Kolossal storico-drammatico
Regia e Produzione: D.W.Griffith
Sceneggiatura: Thomas F. Dixon Jr., D.W. Griffith, Frank E. Woods
Fotografia: G.W. Bitzer
Musiche originali: Joseph Carl Breil, D.W. Griffith, Jon Mirsalis
Musiche non originali: da Edvard Grieg, Philip Phile (da "Hail Columbia") e Richard Wagner
Montaggio: D.W. Griffith, Joseph Henabery, James Smith, Rose Smith, Raoul Walsh

Cast: Lillian Gish: Elsie Stoneman
Mae Marsh: Miriam Cooper
Henry B. Walthall: Colonnello Ben Cameron
Miriam Cooper: Margaret Cameron
Mary Alden: Lydia Brown
Ralph Lewis: Austin Stoneman
George Siegmann: Silas Lynch
Walter Long: Gus
Robert Harron: Tod Stoneman
Wallace Reid: Jeff
Joseph Henabery: Abramo Lincoln
Elmer Clifton: Phil Stoneman
Josephine Crowell: Mrs. Cameron
Spottiswoode Aitken: Dr. Cameron
George Beranger: Wade Cameron
Maxfield Stanley: Duke Cameron
Jennie Lee: Mammy
Donald Crisp: Generale Ulysses S. Grant
Howard Gaye: Generale Robert E. Lee
Sam De Grasse: Senatore Sumner
William De Vaull: Jake
John Ford: Klansman
Olga Grey: Laura Keene
William Freeman: sentinella
Raoul Walsh: John Wilkes Booth
Violet Wilkey: Flora
Tom Wilson: servo
Olga Grey: Laura Keene
Alberta Lee: signora Lincoln
Elmo Lincoln: fabbro ferraio
Bessie Love: ragazza
Donna Montran: donna
Eugene Pallette: soldato dell'unione
Charles Stevens: volontario

Non accreditati:
Bobby Burns: Capo del Ku Klux Klan
Lenore Cooper: Elsie
Alma Rubens: donna
Madame Sul-Te-Wan: donna nera
Mary Wynn: ragazza con foglio
Erich von Stroheim: uomo sul tetto 

0=============================0

.: Info Ripping :.

Filesize.....: 1,444 MB
Runtime......: 02:44:25
Video Codec..: DivX 5.0
Video Bitrate: 1094 kb/s
Frame Rate...: 25.000 frames per second
Audio Codec..: MP3
Audio Bitrate: 128 kb/s (64/ch, stereo) CBR
Frame Size...: 680x540 (1.26:1) [=34:27]