Autobiography Collection




Autobiography: General	

The Know-It-All: One Man's Humble Quest to Become the Smartest Person in the World	 - A. J. Jacobs
The Year of Living Biblically: One Man's Humble Quest to Follow the Bible as Literally as Possible	 - A. J. Jacobs
The Poison King: The Life and Legend of Mithradates, Rome's Deadliest Enemy	 - Adrienne Mayor
Agahta Christie: An Autobiography	 - Agatha Christie
The Second Coming of Steve Jobs	 - Alan Deutschman
Richard Dawkins: How a Scientist Changed the Way We Think : Reflections by Scientists, Writers, and Philosophers	 - Alan Grafen, Mark Ridley
I, Partridge	 - Alan Partridge
The House of Wittgenstein: A Family at War	 - Alexander Waugh
Don't Let's Go to the Dogs Tonight: An African Childhood	 - Alexandra Fuller
Scribbling the Cat	 - Alexandra Fuller
Children of Dust: A Memoir of Pakistan	 - Ali Eteraz
The Snowball: Warren Buffett and the Business of Life	 - Alice Schroeder
Confessions of a Prairie Bitch: How I Survived Nellie Oleson and Learned to Love Being Hated	 - Alison Arngrim
Battle Hymn of the Tiger Mother	 - Amy Chua
Townie: A Memoir	 - Andre Dubus, Iii
Keeper: One House, Three Generations, and a Journey Into Alzheimer's	 - Andrea Gillies
Party Girl: A Novel	 - Anna David
You Say Tomato, I Say Shut Up	 - Annabelle Gurwitch
Ayn Rand and the World She Made	 - Anne C. Heller
Must You Go?	 - Antonia Fraser
Straight Life	 - Art Pepper, Laurie Pepper
Magical Thinking	 - Augusten Burroughs
Running the Books: The Adventures of an Accidental Prison Librarian	 - Avi Steinberg
Journals of Ayn Rand	 - Ayn Rand, Leonard Peikoff, David Harriman
Rivethead	 - Ben Hamper
My Korean Deli: Risking It All for a Convenience Store	 - Ben Ryder Howe
Confessions of a GP	 - Benjamin Daniels
The Imaginations of Unreasonable Men: Inspiration, Vision, and Purpose in the Quest to End Malaria	 - Bill Shore
Cheever: A Life	 - Blake Bailey
Flannery: A Life of Flannery O'Connor	 - Brad Gooch
The Council of Dads	 - Bruce Feiler
The Gates of November	 - Chaim Potok
When Broken Glass Floats: Growing Up Under the Khmer Rouge	 - Chanrithy Him
What I Learned When I Almost Died	 - Chris Licht
Elephant Man	 - Christine Sparks
Hitch-22: A Memoir	 - Christopher Hitchens
Larry's Kidney: Being the True Story of How I Found Myself in China With My Black Sheep Cousin and His Mail-Order Bride, Skirting the Law to Get Him a Transplant--And Save His Life	 - Daniel Asa Rose
Zeitoun	 - Dave Eggers
Cocaine's Son: A Memoir	 - Dave Itzkoff
Bobby Fischer Goes to War: How a Lone American Star Defeated the Soviet Chess Machine	 - David Edmonds, John Eidinow
Although of Course You End Up Becoming Yourself: A Road Trip With David Foster Wallace	 - David Lipsky
Catching the Big Fish: Meditation, Consciousness, and Creativity	 - David Lynch
Finding Everett Ruess: The Life and Unsolved Disappearance of a Legendary Wilderness Explorer	 - David Roberts
Beautiful Boy: A Father's Journey Through His Son's Addiction	 - David Sheff
Every Day by the Sun: A Memoir of the Faulkners of Mississippi	 - Dean Faulkner Wells
The Stardust Lounge: Stories From a Boy's Adolescence	 - Deborah Digges
Report From Engine Co. 82	 - Dennis Smith
I'm Sorry You Feel That Way: The Astonishing but True Story of a Daughter, Sister, Slut, Wife, Mother, and Friend to Man and Dog	 - Diana Joseph
African Laughter	 - Doris May Lessing
Two or Three Things I Know for Sure	 - Dorothy Allison
Mr. Strangelove: A Biography of Peter Sellers	 - Ed Sikov
The Hare With Amber Eyes	 - Edmund de Waal
Brother, I'm Dying	 - Edwidge Danticat
All Rivers Run to the Sea: Memoirs	 - Elie Wiesel
Black Milk	 - Elif Shafak
Committed: A Skeptic Makes Peace With Marriage	 - Elizabeth Gilbert
Eat, Pray, Love: One Woman's Search for Everything Across Italy, India and Indonesia	 - Elizabeth Gilbert
An Exact Replica of a Figment of My Imagination: A Memoir	 - Elizabeth McCracken
This Child Will Be Great	 - Ellen Johnson Sirleaf
Klee Wyck	 - Emily Carr, Kathryn Bridge
A Child Al Confino: The True Story of a Jewish Boy and His Mother in Mussolini's Italy	 - Eric Lamet
The Freedom Writers Diary	 - Erin Gruwell, The Freedom Writers
When I Was Puerto Rican	 - Esmeralda Santiago
A Warrior's Life: A Biography of Paulo Coelho	 - Fernando Morais
Endgame: Bobby Fischer's Remarkable Rise and Fall - From America's Brightest Prodigy to the Edge of Madness	 - Frank Brady
Tis: A Memoir	 - Frank McCourt
Crazy for God: How I Grew Up as One of the Elect, Helped Found the Religious Right, and Lived to Take All	 - Frank Schaeffer
I Was Vermeer: The Rise and Fall of the Twentieth Century's Greatest Forger	 - Frank Wynne
Ecce Homo	 - Friedrich Nietzsche
Let's Take the Long Way Home: A Memoir of Friendship	 - Gail Caldwell
Mob Star: The Story of John Gotti	 - Gene Mustain, Jerry Capeci
A Guest in My Own Country	 - George Konrad
The Corfu Trilogy	 - Gerald Durrell
Foreign Correspondence: A Pen Pal's Journey From Down Under to All Over	 - Geraldine Brooks
The Girls of Room 28: Friendship, Hope, and Survival in Theresienstadt	 - Hannelore Brenner-Wonschick, Hannelore Brenner
What I Talk About When I Talk About Running	 - Haruki Murakami
Bitch Is the New Black: A Memoir	 - Helena Andrews
Rocket Boys	 - Homer Hickam
Sky of Stone	 - Homer Hickam
The Coalwood Way	 - Homer Hickam
An Anatomy of Addiction: Sigmund Freud, William Halsted, and the Miracle Drug, Cocaine	 - Howard Markel
Charles Bukowski: Locked in the Arms of a Crazy Life	 - Howard Sounes
The Boy in the Moon: A Father's Search for His Disabled Son	 - Ian Brown
Unbillable Hours: A True Story	 - Ian Graham
Even Silence Has an End: My Six Years of Captivity in the Colombian Jungle	 - Ingrid Betancourt
Hermit in Paris: Autobiographical Writings	 - Italo Calvino, Martin McLaughlin
Yesterday, I Cried: Celebrating the Lessons of Living and Loving	 - Iyanla Vanzant
Summertime: Scenes From Provincial Life	 - J. M. Coetzee
The Tender Bar: A Memoir	 - J. R. Moehringer
Gimme Something Better: The Profound, Progressive, and Occasionally Pointless History of Bay Area Punk From Dead Kennedys to Green Day	 - Jack Boulware, Silke Tudor
Tokyo Vice: An American Reporter on the Police Beat in Japan	 - Jake Adelstein
A Million Little Pieces	 - James Frey
Pulitzer: A Life in Politics, Print, and Power	 - James McGrath Morris
Adland: Searching for the Meaning of Life on a Branded Planet	 - James P. Othmer
The Little Prisoner: A Memoir	 - Jane Elliott, Andrew Crofts
A Stolen Life: A Memoir	 - Jaycee Dugard
Where We Going, Daddy?: Life With Two Sons Unlike Any Other	 - Jean-Louis Fournier
The Glass Castle: A Memoir	 - Jeannette Walls
The Girls From Ames: A Story of Women and a Forty-Year Friendship	 - Jeffrey Zaslow
Woman Who Fell From the Sky	 - Jennifer Steil
From Those Wonderful Folks Who Gave You Pearl Harbor	 - Jerry Della Femina, Charles Sopkin
When I Stop Talking, You'll Know I'm Dead: Useful Stories From a Persuasive Man	 - Jerry Weintraub
Some Girls: My Life in a Harem	 - Jillian Lauren
The Ledge: An Adventure Story of Friendship and Survival on Mount Rainier	 - Jim Davidson, Kevin Vaughan
The Year of Magical Thinking	 - Joan Didion
Mentally Incontinent	 - Joe Peacock
Almost a Family	 - John Darnton
The Sugar King of Havana: The Rise and Fall of Julio Lobo, Cuba's Last Tycoon	 - John Paul Rathbone
Into the Wild	 - Jon Krakauer
Where Men Win Glory	 - Jon Krakauer
Chronic City	 - Jonathan Lethem
The Wolf of Wall Street	 - Jordan Belfort
Small Memories	 - JosÃƒÂ© Saramago, Margaret Jull Costa
Pill Head: The Secret Life of a Painkiller Addict	 - Joshua Lyon
A Widow's Story: A Memoir	 - Joyce Carol Oates
The Tenth Muse	 - Judith Jones
Nothing to Be Frightened Of	 - Julian Barnes
Weekends at Bellevue	 - Julie Holland
American Rose: A Nation Laid Bare: The Life and Times of Gypsy Rose Lee	 - Karen Abbott
An Unquiet Mind	 - Kay Redfield Jamison
Nothing Was the Same: A Memoir	 - Kay Redfield Jamison
Keith Haring Journals	 - Keith Haring, Robert Farris Thompson
Begin Again: A Biography of John Cage	 - Kenneth Silverman
J. D. Salinger: A Life	 - Kenneth Slawenski
Dirty Little Secrets	 - Kerry Cohen
Ghost in the Wires: My Adventures as the World's Most Wanted Hacker	 - Kevin Mitnick, Steve Wozniak, William L. Simon
A Common Pornography: A Memoir	 - Kevin Sampsell
The Royals	 - Kitty Kelley
Stieg Larsson, My Friend	 - Kurdo Baksi
A Man Without a Country	 - Kurt Vonnegut
Palm Sunday: An Autobiographical Collage	 - Kurt Vonnegut
Somewhere Inside	 - Laura Ling, Lisa Ling
Sugar and Spice: An L.A. Candy Novel	 - Lauren Conrad
Prayers for Bobby	 - Leroy Aarons
The Chronology of Water	 - Lidia Yuknavitch
Objects of Our Affection: Uncovering My Family's Past, One Chair, Pistol, and Pickle Fork at a Time	 - Lisa Tracy
Breaking Night	 - Liz Murray
Proust's Overcoat	 - Lorenza Foschini, Eric Karpeles
First They Killed My Father: A Daughter of Cambodia Remembers	 - Loung Ung
An Education	 - Lynn Barber
Swimming to Antarctica: Tales of a Long-Distance Swimmer	 - Lynne Cox
Tip It!: The World According to Maggie	 - Maggie Griffin
The Gang That Wouldn't Write Straight: Wolfe, Thompson, Didion, Capote, and the New Journalism Revolution	 - Marc Weingarten
American Chica: Two Worlds, One Childhood	 - Marie Arana
The Fortunate Pilgrim	 - Mario Puzo
Autobiography of Mark Twain, Vol. 1	 - Mark Twain
Just Like Someone Without Mental Illness Only More So: A Memoir	 - Mark Vonnegut
The Eden Express: A Memoir of Insanity	 - Mark Vonnegut
Travels With Myself and Another	 - Martha Gellhorn
The Will of the People: Winston Churchill and Parliamentary Democracy	 - Martin Gilbert
Fall to Pieces: A Memoir of Drugs, Rock 'N' Roll, and Mental Illness	 - Mary Forsberg Weiland, Larkin Warren
Lit	 - Mary Karr
The Cure for Anything Is Salt Water: How I Threw My Life Overboard and Found Happiness at Sea	 - Mary South
Two Kisses for Maddy: A Memoir of Loss & Love	 - Matthew Logelin
I Love a Broad Margin to My Life	 - Maxine Hong Kingston
The Woman Warrior: Memoirs of a Girlhood Among Ghosts	 - Maxine Hong Kingston
A Song Flung Up to Heaven	 - Maya Angelou
Gather Together in My Name	 - Maya Angelou
I Know Why the Caged Bird Sings	 - Maya Angelou
Letter to My Daughter	 - Maya Angelou
Singin' and Swingin' and Gettin' Merry Like Christmas	 - Maya Angelou
The Heart of a Woman	 - Maya Angelou
Then They Came for Me: A Family's Story of Love, Captivity, and Survival	 - Maziar Bahari, Aimee Molloy
Every Man in This Village Is a Liar: An Education in War	 - Megan K. Stack
This Life Is in Your Hands: One Dream, Sixty Acres, and a Family Undone	 - Melissa Coleman
Hero: The Life and Legend of Lawrence of Arabia	 - Michael Korda
The Blind Side: Evolution of a Game	 - Michael Lewis
A Place of My Own: The Architecture of Daydreams	 - Michael Pollan
Will Eisner	 - Michael Schumacher
Wreck of the Carl D.: A True Story of Loss, Survival, and Rescue at Sea	 - Michael Schumacher
Down Among the Dead Men: A Year in the Life of a Mortuary Technician	 - Michelle Williams
Tide, Feather, Snow: A Life in Alaska	 - Miranda Weiss
Hands of My Father: A Hearing Boy, His Deaf Parents, and the Language of Love	 - Myron Uhlberg
In the Sanctuary of Outcasts: A Memoir	 - Neil White
Tweak: Growing Up on Methamphetamines	 - Nic Sheff
Wiseguy: Life in a Mafia Family	 - Nicholas Pileggi
Three Weeks With My Brother	 - Nicholas Sparks, Micah Sparks
Fever Pitch	 - Nick Hornby
Tolstoy and the Purple Chair: My Year of Magical Reading	 - Nina Sankovitch
Voluntary Madness: My Year Lost and Found in the Loony Bin	 - Norah Vincent
A Ticket to the Circus: A Memoir	 - Norris Church Mailer
Thoughts Without Cigarettes: A Memoir	 - Oscar Hijuelos
Alfred Hitchcock: A Life in Darkness and Light	 - Patrick McGilligan
Just Kids	 - Patti Smith
Idea Man: A Memoir by the Cofounder of Microsoft	 - Paul Allen
Black Is the New White	 - Paul Mooney, Dave Chappelle
An Ordinary Man	 - Paul Rusesabagina, Tom Zoellner
An Ordinary Man: An Autobiography	 - Paul Rusesabagina, Tom Zoellner
Keeping the Feast	 - Paula Butturini
The Pilgrimage: A Contemporary Quest for Ancient Wisdom	 - Paulo Coelho
Drinking Life	 - Pete Hamill
Poe	 - Peter Ackroyd
Unbearable Lightness: A Story of Loss and Gain	 - Portia de Rossi
In the Land of Invisible Women: A Female Doctor's Journey in the Saudi Kingdom	 - Qanta Ahmed
Creation: Darwin, His Daughter & Human Evolution	 - Randal Keynes
The Last Lecture	 - Randy Pausch, Jeffrey Zaslow
The Immortal Life of Henrietta Lacks	 - Rebecca Skloot
A Time to Betray: The Astonishing Double Life of a CIA Agent Inside the Revolutionary Guards of Iran	 - Reza Kahili
Surely You're Joking, Mr. Feynman!	 - Richard P. Feynman
Black Boy	 - Richard Wright
All Over but the Shoutin'	 - Rick Bragg
Ava's Man	 - Rick Bragg
The Prince of Frogtown	 - Rick Bragg
Love Is a Mix Tape: Life and Loss, One Song at a Time	 - Rob Sheffield
Talking to Girls About Duran Duran: One Young Man's Quest for True Love and a Cooler Haircut	 - Rob Sheffield
The Company We Keep: A Husband-And-Wife True-Life Spy Story	 - Robert Baer, Dayna Baer
Boyd	 - Robert Coram
Pieces of My Heart: A Life	 - Robert J. Wagner, Scott Eyman
Target	 - Robert K. Wilcox
The Accountant's Story: Inside the Violent World of the MedellÃƒ n Cartel	 - Roberto Escobar, David Fisher
Chinaberry Sidewalks	 - Rodney Crowell
Life Itself	 - Roger Ebert
The Boys of Summer	 - Roger Kahn
Titan: The Life of John D. Rockefeller, Sr	 - Ron Chernow
The Secret History of Rock: The Most Influential Bands You've Never Heard	 - Roni Sarig
Between Two Worlds	 - Roxana Saberi
Ugly Beauty: Helena Rubinstein, L'OrÃƒÂ©al, and the Blemished History of Looking Good	 - Ruth Brandon
Comfort Me With Apples	 - Ruth Reichl
Nothing to Lose, Everything to Gain: How I Went From Gang Member to Multimillionaire Entrepreneur	 - Ryan Blair
Fifth Avenue, 5 A.M.: Audrey Hepburn, Breakfast at Tiffany's, and the Dawn of the Modern Woman	 - Sam Wasson
Saul Bellow: Letters	 - Saul Bellow, Benjamin Taylor
Happy Chaos	 - Soleil Moon Frye
The Journals of Spalding Gray	 - Spalding Gray, Nell Casey
On the Grand Trunk Road	 - Steve Coll
The Bin Ladens: An Arabian Family in the American Century	 - Steve Coll
IWoz: Computer Geek to Cult Icon : How I Invented the Personal Computer, Co-Founded Apple, and Had Fun Doing It	 - Steve Wozniak, Gina Smith
Gang Leader for a Day: A Rogue Sociologist Takes to the Streets	 - Sudhir Alladi Venkatesh
Fixing My Gaze	 - Susan R. Barry, Oliver Sacks
Big Sex Little Death: A Memoir	 - Susie Bright
Thinking in Pictures: And Other Reports From My Life With Autism	 - Temple Grandin
Piano Shop on the Left Bank	 - Thad Carhart, Thaddeus Carhart
Lucky Child	 - Thomas Buergenthal
Searching for Schindler	 - Thomas Keneally
Ill Fares the Land	 - Tony Judt
The Memory Chalet	 - Tony Judt
Hiding Man: A Biography of Donald Barthelme	 - Tracy Daugherty
A House for Mr. Biswas	 - V. S. Naipaul
Beware of Cat: And Other Encounters of a Letter Carrier	 - Vincent Wyckoff
Steve Jobs	 - Walter Isaacson
Lost in the Meritocracy	 - Walter Kirn
Outcasts United	 - Warren St. John
The Wilder Life: My Adventures in the Lost World of Little House on the Prairie	 - Wendy McClure
The Other Wes Moore: One Name, Two Fates	 - Wes Moore
In the Place of Justice: A Story of Punishment and Deliverance	 - Wilbert Rideau
The Last Tycoons: The Secret History of Lazard FrÃƒÂ¨res & Co	 - William D. Cohan
A Jane Austen Education	 - William Deresiewicz
We Did Porn: Memoir and Drawings	 - Zak Smith
Dust Tracks on a Road	 - Zora Neale Hurston, Maya Angelou
Why We Suck: A Feel Good Guide to Staying Fat, Loud, Lazy and Stupid	 - Denis Leary
Sleepwalk With Me: And Other Painfully True Stories	 - Mike Birbiglia

Autobiography: Celeberties	

Baby, Let's Play House: Elvis Presley and the Women Who Loved Him	 - Alanna Nash
Whatever You Say I Am: The Life and Times of Eminem	 - Anthony Bozza
All That Is Bitter and Sweet: A Memoir	 - Ashley Judd, Nicholas D. Kristof, Maryanne Vollers
Lady Blue Eyes: My Life With Frank	 - Barbara Sinatra
Mud Sweat & Tears	 - Bear Grylls
If You Ask Me	 - Betty White
Lost in the Funhouse: The Life and Mind of Andy Kaufman	 - Bill Zehme
700 Sundays	 - Billy Crystal
Priceless Memories	 - Bob Barker, Digby Diehl
No Regrets	 - Carolyn Burke
Amy Winehouse: The Biography	 - Chas Newkey-Burden
Neon Angel	 - Cherie Currie, Tony O'neill
A Lion's Tale: Around the World in Spandex	 - Chris Jericho
Kate: Kate Middleton	 - Claudia Joseph
Hank Williams	 - Colin Escott, George Merritt, William MacEwen
Cybill Disobedience	 - Cybill Shepherd, Aimee Lee Ball
Chords of Strength: A Memoir of Soul, Song and the Power of Perseverance	 - David Archuleta, Monica Haim
My Lucky Life in and Out of Show Business: A Memoir	 - Dick Van Dyke
Possessed: The Life of Joan Crawford	 - Donald Spoto
Where Mercy Is Shown, Mercy Is Given	 - Duane Dog Chapman
It's So Easy	 - Duff Mckagan
Seriously...I'm Kidding	 - Ellen DeGeneres
Clapton: The Autobiography	 - Eric Clapton
Neil Young: Long May You Run	 - Gary Graff, Daniel Durchholz
Mr Nice: An Autobiography	 - Howard Marks
Senor Nice	 - Howard Marks
Fab: An Intimate Life of Paul McCartney	 - Howard Sounes
Here's the Deal: Don't Touch Me	 - Howie Mandel, Josh Young
Ice: A Memoir of Gangster Life and Redemption--From South Central to Hollywood	 - Ice-T, Douglas Century
Michael Jackson: The Magic, the Madness, the Whole Story, 1958-2009	 - J. Randy Taraborrelli
The Secret Life of Marilyn Monroe	 - J. Randy Taraborrelli
Frank: The Voice	 - James Kaplan
Seven Dirty Words: The Life and Crimes of George Carlin	 - James Sullivan
Decoded	 - Jay-Z
Jeff Corwin: A Wild Life : The Authorized Biography	 - Jeff Corwin
I Want to Take You Higher: The Life and Times of Sly & the Family Stone	 - Jeff Kaliss
Love, Lust & Faking It: The Naked Truth About Sex, Lies, and True Romance	 - Jenny McCarthy
I Met the Walrus: How One Day With John Lennon Changed My Life Forever	 - Jerry Levitan
Dean and Me: A Love Story	 - Jerry Lewis, James Kaplan
American Outlaw	 - Jesse James
Tommy Cooper: Always Leave Them Laughing	 - John Fisher
I Just Want You to Know: Letters to My Kids on Love, Faith, and Family	 - Kate Gosselin
Life	 - Keith Richards, James Fox (Contributor)
Being Kendra: Cribs, Cocktails, and Getting My Sexy Back	 - Kendra Wilkinson
His Way: The Unauthorized Biography of Frank Sinatra	 - Kitty Kelley
Oprah: A Biography	 - Kitty Kelley
Loretta Lynn: Coal Miner's Daughter	 - Loretta Lynn, George Vecsey
High on Arrival	 - Mackenzie Phillips, Hilary Liftin
Might as Well Laugh About It Now	 - Marie Osmond, Marcia Wilkie
Growing Up Laughing: My Story and the Story of Funny	 - Marlo Thomas
Brando: Songs My Mother Taught Me	 - Marlon Brando, Robert Lindsey
The Elephant to Hollywood	 - Michael Caine
Robert Redford	 - Michael Feeney Callan
A Funny Thing Happened on the Way to the Future: Twists and Turns and Lessons Learned	 - Michael J. Fox
Life and Laughing: My Story	 - Michael McIntyre
John Wayne : The Man Behind the Myth	 - Michael Munn
Diaries 1969-1979: The Python Years	 - Michael Palin
Priceless	 - Nicole Richie
I Am Ozzy	 - Ozzy Osbourne, Chris Ayres
Between a Heart and a Rock Place: A Memoir	 - Pat Benatar, Patsi Bale Cox
We'll Be Here for the Rest of Our Lives: A Swingin' Show-Biz Saga	 - Paul Shaffer, David Ritz
Dream Boogie: The Triumph of Sam Cooke	 - Peter Guralnick
Man of Constant Sorrow: My Life and Times	 - Ralph Stanley, Eddie Dean
Me	 - Ricky Martin
Blonde Ambition: The Untold Story Behind Anna Nicole Smith's Death	 - Rita Cosby
Stories I Only Tell My Friends: An Autobiography	 - Rob Lowe
My Word Is My Bond: A Memoir	 - Roger Moore, Gareth Owen
The Hardest (Working) Man in Showbiz	 - Ron Jeremy
Furious Love: Elizabeth Taylor, Richard Burton, and the Marriage of the Century	 - Sam Kashner, Nancy Schoenberger
Red	 - Sammy Hagar
Bob Dylan in America	 - Sean Wilentz
From This Moment On	 - Shania Twain
Somebody: The Reckless Life and Remarkable Career of Marlon Brando	 - Stefan Kanfer
Fry: A Memoir	 - Stephen Fry
Professional Idiot: A Memoir	 - Stephen Glover
My Appetite for Destruction: Sex, and Drugs, and Guns N' Roses	 - Steven Adler
Does the Noise in My Head Bother You?: A Rock 'N' Roll Memoir	 - Steven Tyler
All My Life: A Memoir	 - Susan Lucci, Laura (CON) Morton
Sinner Takes All: A Memoir of Love & Porn	 - Tera Patrick; Carrie Borzillo
The Sinatra Files: The Secret FBI Dossier	 - Tom Kuntz, Phil Kuntz
Is It Just Me?: Or Is It Nuts Out There?	 - Whoopi Goldberg
Shatner Rules	 - William Shatner, Chris Regan

Autobiography: Food & Travel	

Big in China: My Unlikely Adventures Raising a Family, Playing the Blues, and Becoming a Star in Beijing	 - Alan Paul
Kitchen Confidential: Adventures in the Culinary Underbelly	 - Anthony Bourdain
Medium Raw: A Bloody Valentine to the World of Food and the People Who Cook	 - Anthony Bourdain
Between a Rock and a Hard Place	 - Aron Ralston
Heat: An Amateur's Adventures as Kitchen Slave, Line Cook, Pasta-Maker, and Apprentice to a Dante-Quoting Butcher in Tuscany	 - Bill Buford
The Lost City of Z: A Tale of Deadly Obsession in the Amazon	 - David Grann
Blood, Bones, and Butter: The Inadvertent Education of a Reluctant Chef	 - Gabrielle Hamilton
My Life in France	 - Julia Child, Alex Prud'homme
Cleaving	 - Julie Powell
Julia Child: A Life	 - Laura Shapiro
Hallelujah! The Welcome Table: A Lifetime of Memories With Recipes	 - Maya Angelou
The Reach of a Chef: Beyond the Kitchen	 - Michael Ruhlman
Appetite for Life: The Biography of Julia Child	 - Noel Riley Fitch
Farm City: The Education of an Urban Farmer	 - Novella Carpenter
The Pat Conroy Cookbook: Recipes and Stories of My Life	 - Pat Conroy
30 Days in Sydney: A Wildly Distorted Account	 - Peter Carey
Tender at the Bone: Growing Up at the Table	 - Ruth Reichl
The Lady and the Panda: The True Adventures of the First American Explorer to Bring Back China's Most Exotic Animal	 - Vicki Croke

Autobiography: Politics & Religon	

Unplanned: The Dramatic True Story of a Former Planned Parenthood Leader's Eye-Opening Journey Across the Life Line	 - Abby Johnson, Cindy Lambert
The Audacity of Hope	 - Barack Obama
Nearing Home	 - Billy Graham
Ronnie and Nancy: Their Path to the White House	 - Bob Colacello
Escape	 - Carolyn Jessop, Laura Palmer
Come to the Edge: A Memoir	 - Christina Haag
Barack and Michelle	 - Christopher P. Andersen
No Higher Honor	 - Condoleezza Rice
Tears of a Clown: Glenn Beck and the Tea Bagging of America	 - Dana Milbank
My Year Inside Radical Islam: A Memoir	 - Daveed Gartenstein-Ross
The Bridge: The Life and Rise of Barack Obama	 - David Remnick
Rawhide Down: The Near Assassination of Ronald Reagan	 - Del Quentin Wilber
In My Time	 - Dick Cheney, Liz Cheney
Known and Unknown	 - Donald Rumsfeld
Known and Unknown: A Memoir	 - Donald Rumsfeld
True Compass: A Memoir	 - Edward M. Kennedy
Resilience: Reflections on the Burdens and Gifts of Facing Life's Adversities	 - Elizabeth Edwards
Letters to Jackie: Condolences From a Grieving Nation	 - Ellen Fitzpatrick
Bonhoeffer: Pastor, Martyr, Prophet, Spy: A Righteous Gentile vs. The Third Reich	 - Eric Metaxas
Teaching the Pig to Dance: A Memoir	 - Fred Thompson
At the Center of the Storm: My Years at the CIA	 - George Tenet, Bill Harlow
Decision Points	 - George W. Bush
On the Brink: Inside the Race to Stop the Collapse of the Global Financial System	 - Henry M. Paulson
This Is Herman Cain!	 - Herman Cain
A Singular Woman	 - Janny Scott
Without a Word: How a Boy's Unspoken Love Changed Everything	 - Jill Kelly, Tim McGraw, Faith Hill
The Spiral Staircase: My Climb Out of Darkness	 - Karen Armstrong
William and Harry	 - Katie Nicholl, C Nicholl
The Boy Who Came Back From Heaven: A Remarkable Account of Miracles, Angels, and Life Beyond This World	 - Kevin Malarkey, Alex Malarkey
Spoken From the Heart	 - Laura Bush
The Kennedy Men: 1901-1963	 - Laurence Leamer
Read My Pins: Stories From a Diplomat's Jewel Box	 - Madeleine Albright, Madeleine Korbel Albright
Winston Churchill's War Leadership	 - Martin Gilbert
Dirty Sexy Politics	 - Meghan McCain
Here Comes Trouble	 - Michael Moore
Have a Little Faith	 - Mitch Albom
The Long Walk to Freedom	 - Nelson Mandela
The Obamas: The Untold Story of an African Family	 - Peter Firstbrook
An American Life	 - Ronald Reagan
In the Words of Ronald Reagan: The Wit, Wisdom, and Eternal Optimism of America's 40th President	 - Ronald Reagan, Michael Reagan, James D. Denney
Against All Odds: My Life of Hardship, Fast Breaks, and Second Chances	 - Scott Brown
Kennedy: The Classic Biography	 - Ted Sorensen
A Journey: My Political Life	 - Tony Blair
Fair Game	 - Valerie Plame Wilson
Reading Jackie: Her Autobiography in Books	 - William Kuhn

Autobiography: Sports	

Death Clutch	 - Brock Lesnar, Paul Heyman
Undisputed: How to Become the World Champion in 1,372 Easy Steps	 - Chris Jericho, Peter Thomas Fornatale
The Last Hero: A Life of Henry Aaron	 - Howard Bryant
The Last Boy: Mickey Mantle and the End of America's Childhood	 - Jane Leavy
Sweetness: The Enigmatic Life of Walter Payton	 - Jeff Pearlman
The Yankee Years	 - Joe Torre, Tom Verducci
Tommy's Honor: The Story of Old Tom Morris and Young Tom Morris, Golf's Founding Father and Son	 - Kevin Cook
We Were Young and Carefree	 - Laurent Fignon
I Beat the Odds: From Homelessness, to the Blind Side, and Beyond	 - Michael Oher
Rafa	 - Rafael Nadal, John Carlin
Sweet Thunder: The Life and Times of Sugar Ray Robinson	 - Wil Haygood

Autobiography: Other	

The Courtier and the Heretic: Leibniz, Spinoza, and the Fate of God in the Modern World	 - Matthew Stewart
How to Live: A Life of Montaigne in One Question and Twenty Attempts at an Answer	 - Sarah Bakewell
Genius: The Life and Science of Richard Feynman	 - James Gleick
Kingpin: How One Hacker Took Over the Billion Dollar Cyber Crime Underground	 - Kevin Poulsen
Pink Boots and a MacHete: My Journey From NFL Cheerleader to National Geographic Explorer	 - Mireya Mayor, Jane Goodall


Enjoy and Seed!!