TÃTULO ORIGINAL 	Lacombe Lucien
AÃ‘O 	
1974 	
DURACIÃ“N 	
140 min. 	  Sugerir trailer/vÃ­deo
PAÃS 	
[Francia] 	  SecciÃ³n visual
DIRECTOR 	Louis Malle
GUIÃ“N 	Louis Malle & Patrick Modiano
MÃšSICA 	Django Reinhardt
FOTOGRAFÃA 	Tonino Delli Colli
REPARTO 	Pierre Blaise, Aurore ClÃ©ment, ThÃ©rÃ¨se Giehse, Holger Lowenadler, Jean Bousquet, Jean Rougerie, RenÃ© Bouloc, Jacques Rispal, StÃ©phane Bouy
PRODUCTORA 	CoproducciÃ³n Francia-Italia-RFA; N.E.F./ U.P.F. / Vides Films / Hallelujah Film
PREMIOS 	1974: Nominada al Oscar: Mejor pelÃ­cula de habla no inglesa
1974: BAFTA: Mejor pelÃ­cula
GÃ‰NERO 	Drama | II Guerra Mundial
SINOPSIS 	Durante la Segunda Guerra Mundial Lacombe, un joven campesino cuyo padre estÃ¡ prisionero en Alemania y cuya madre se acuesta con su jefe, intenta ingresar en la Resistencia. Rechazado por el cabecilla local, ingresa por azar en la policÃ­a alemana. Con una capacidad asombrosa para amoldarse a lo que su nuevo puesto le exige, su vida cambia cuando se enamora de France, la hija de un sastre judÃ­o. (FILMAFFINITY)

CRÃTICAS 	----------------------------------------
ProvocÃ³ polÃ©mica en Francia al atreverse con un tema tabÃº: la postura de la sociedad civil francesa ante la ocupaciÃ³n nazi. Estuvo nominada al Oscar a la Mejor PelÃ­cula de habla no inglesa. (FILMAFFINITY)
----------------------------------------
"PelÃ­cula narrativamente clara, emotiva y Ã©ticamente seria" (Francisco Marinero: Diario El Mundo) 