TÃTULO ORIGINAL 	The Killer Inside Me
AÃ‘O 	
2010 	
DURACIÃ“N 	
108 min. 	  Trailers/VÃ­deos
PAÃS 	
[Estados Unidos] 	  SecciÃ³n visual
DIRECTOR 	Michael Winterbottom
GUIÃ“N 	Michael Winterbottom, Robert D. Weinbach (Novela: Jim Thompson)
MÃšSICA 	Melissa Parmenter
FOTOGRAFÃA 	Marcel Zyskind
REPARTO 	Casey Affleck, Jessica Alba, Kate Hudson, Bill Pullman, Ned Beatty, Elias Koteas, Simon Baker
PRODUCTORA 	Cyclone Productions / Muse Productions
PREMIOS 	2010: Premios Razzie: Peor actriz (Jessica Alba)
GÃ‰NERO 	Drama. Thriller | Crimen. AÃ±os 50. Drama sureÃ±o
SINOPSIS 	En 1957, en una pequeÃ±a poblaciÃ³n petrolera situada al oeste de Texas, Lou Ford (Casey Affleck), el ayudante del sheriff, un hombre afable y sencillo, empieza a sufrir los ataques de la enfermedad que le hizo cometer un crimen en su juventud. AdaptaciÃ³n de un clÃ¡sico de la novela negra moderna, "The Killer Inside Me" (1952), de Jim Thompson, que ya habÃ­a sido adaptado por Burt Kennedy. (FILMAFFINITY)

CRÃTICAS 	----------------------------------------
"Deslumbrante y depravado cine negro. (...) Affleck ofrece una fascinante y poderosa interpretaciÃ³n (...) PuntuaciÃ³n: *** (sobre 4)" (Peter Travers: Rolling Stone)
----------------------------------------
"'The Killer Inside Me' podrÃ­a ser el noir mÃ¡s oscuro que jamÃ¡s se ha hecho. (...) No te arrastra al interior de un vÃ³rtice - te deja en el exterior, echando un vistazo y un poco estupefacto" (Owen Gleiberman: Entertainment Weekly)
----------------------------------------