100 Greatest One Hit Wonders Of The 80s 

A-Ha - Take on me
After The Fire - Der Kommissar
Alannah Myles - Black Velvet
Animotion - Obsession
Bertie Higgins - Key Largo
Big Country - In A Big Country
Billy Vera - At This Moment
Bobby McFerrin - Don't Worry Be Happy
Boomtown Rats - I Don't Like Mondays
Bow Wow Wow - I Want Candy
Bruce Willis - Respect Yourself
Buckner & Garcia - Pac-Man Fever
Chris De Burg - Lady In Red
Clarence Clemons & Jackson Browne - You're A Friend Of Mine
Club Nouveau - Lean On Me
Cutting Crew - I Just Died In Your Arms Tonight
Dead Or Alive - You Spin Me Round (Like A Record)
Devo - Whip It
Dexys Midnight Runners - Come On Eileen
Don Johnson - Heartbeat
E.U. - Da Butt
Eddie Murphy - Party All The Time
Eddy Grant - Electric Avenue
Edie Brickell & New Bohemians - What I Am
Edie Brickell & New Bohemians - What I Am
Flock Of Seagulls - I Ran (So Far Away)
Frank Stallone - Far From Over
Frankie Goes To Hollywood - Relax
Gary Numan - Cars
General Public - Tenderness
Georgia Satellites - Keep Your Hands To Yourself
Gloria Loring & Carl Anderson - Friends And Lovers
Haircut 100 - Love Plus One
Harold Faltermeyer - Axel F
Information Society - What's On Your Mind (Pure Energy)
J.J. Fad - Supersonic
Jack Wagner - All I Need
Jermaine Stewart - We Don't Have To Take Our Clothes Off
John Parr - St. Elmos Fire (Man In Motion)
John Waite - Missing You
Johnny Kemp - Just got paid
Josie Cotton - Johnny, are you queer
Kajagoogoo - Too Shy
L.A. Guns - The Ballad Of Jayne
Lipps, Inc - Funkytown
Madness - Our House
Martika - Toy Soldiers
Mary Jane Girls - In My House
Matthew Wilder - Break My Stride
Men Without Hats - The Safety Dance
Michael Damian - Rock On
Michael Sembello - Maniac
Midnight Oil - Beds Are Burning
Modern English - I Melt With You
Musical Youth - Pass The Dutchie
Nena - 99 Luft Balloons
Neneh Cherry - Buffalo Stance
Nik Kershaw - Wouldn't It Be Good
Nu Shooz - I can't Wait
Oran 'Juice' Jones - The Rain
Patrice Rushen - Forget Me Nots
Paul Hardcastle - 19
Paul Lekakis - Boom Boom Boom Let's Go Back To My Room
Peter Schilling - Major Tom
Philip Bailey & Phil Collins - Easy Lover
Pretty Poison - Catch Me I'm Falling
Quarterflash - Harden My Heart
Red Rider - Lunatic Fringe
Rob Base & Dj E-Z Rock - It Takes Two
Robbie Dupree - Steal Away
Robbie Nevil - C'est La Vie
Rockwell - Somebody's Watching Me
Rodney Dangerfield - Rappin' Rodney
Shannon - Let The Music Play
Soft Cell - Tainted Love
Stacey Q - Two Of Hearts
Swing out Sister - Breakout
T'Pau - Heart and Soul
Taco - Puttin' On The Ritz
The Buggles - Video Killed The Radio Star
The Church - Under The Milky Way
The Fabulous Thunderbirds - Tuff Enuff
The Jeff Healy Band - Angel Eyes
The Outfield - Your Love
The Vapors - Turning Japanese
The Waitresses - I Know What Boys Like
The Weather Girls - It's Raining Men
Thomas Dolby - She Blinded Me With Science
Til Tuesday - Voices Carry
Timbuk 3 - The Future's So Bright, I Gotta Wear Shades.mp3
Tom Tom Club - Genius Of Love
Tommy Tutone - 867-5309 Jenny
Toni Basil - Hey Mickey
Twisted Sister - We're Not Gonna Take It
Vixen - Edge Of A Broken Heart
Wall Of Voodoo - Mexican Radio
Will To Power - Baby I Love Your Way - Freebird
XTC - Dear God
Yello - Oh Yeah
Ziggy Marley & The Melody Makers - Tomorrow People