September 15-18, 2011

2011 Mr. Olympia Qualified  	Country

Abiad, Fouad 	Canada
Alves, Troy 	USA
Beyeke, Lionel 	France
Burneika, Robert 	USA
Centopani, Evan 	USA
Curry, Brandon 	USA
Cutler, Jay 	USA
Dohne, Marius 	South Africa
Freeman, Toney 	USA
Greene, Kai 	USA
Heath, Phil 	USA
Haley, Marcus 	USA
Jackson, Dexter 	USA
Jackson, Johnnie 	USA
Kefalianos, Michael 	Australia
Lavoie, Marc 	Canada
Lewis, James 	United Kingdom
Martinez, Victor 	Dominican Republic
McGrath, Frank 	Canada
McMillan, Cedric 	USA
Mishin, Evgeny 	Russia
Nunn, Edward 	USA
Piotrkowicz, Robert 	Poland
Rhoden, Shawn 	USA
Richardson, Craig 	USA
Rockel, Ronny 	Germany
Warren, Branch 	USA
White, Ben 	USA
Winklaar, Roelly 	Netherlands
Wolf, Dennis 	Germany
Yamagishi, Hidetada 	Japan