Disc: 1 	
1. Isn't This a Lovely Day 
2. Puttin' on the Ritz 	
3. I Used to Be Color Blind 
4. The Continental 
5. Let's Call the Whole Thing Off 	
6. Change Partners 	
7. 'S Wonderful 	
8. Lovely to Look At 	
9. They All Laughed 	
10. Cheek to Cheek 	
11. Steppin' Out with My Baby 	
12. The Way You Look Tonight 	
13. I've Got My Eyes on You 	
14. Dancing in the Dark 	
15. The Carioca 	
16. Nice Work If You Can Get It 	
17. New Sun in the Sky 	
18. I Won't Dance 	
19. Fast Dances [Instrumental] 	
20. Top Hat, White Tie and Tails 
21. No Strings 	Listen
22. I Concentrate on You 
23. I'm Putting All My Eggs in One Basket 

Disc: 2 
1. A Fine Romance 	
2. Night and Day 	
3. Fascinating Rhythm 	
4. I Love Louisa 	
5. Slow Dances [Instrumental] 	
6. Medium Dance [Instrumental] 	
7. They Can't Take That Away from Me 
8. You're Easy to Dance With 	
9. A Needle in a Haystack 	
10. So Near and Yet So Far Away 	
11. A Foggy Day 	Listen
12. Oh, Lady Be Good 	Listen
13. I'm Building Up to an Awful Letdown 	
14. Not My Girl 	Listen
15. Jam Session for a Dancer [Instrumental] 
16. The Astaire Blues [Instrumental]
17. The Second Astaire Blues [Instrumental] 