Suzy Solar
Solar Power Sessions 483
GUEST: Akira Kayosa

Quality: mp3@256
Release: 12.01.2011
Genre: Trance Uplifting
Source: Radio http://www.1mix.co.uk/
Official Suzy Website: http://suzysolar.com/
Ripper: Azumi

Tracklist:

Hour 1: Suzy Solar:

01. Dave Deen - Killer Worms (A.T.M. Remix) [Silent Shore Records]
02. Ciro Visone - Heroes (Mohamed Ragab Remix) [Spellbinding Records]
03. Masoud feat Laurie - Blinded (Sebastian Brandt Remix) [Levare Recordings]
04. ReOrder - Angels (Faruk Sabanci Remix) [Flashover Recordings]
05. John Askew - Intimate Strangers (Original Mix) [FSOE Recordings]
06. Sean Truby - Now Or Never (Original Mix) [Infrasonic Recordings]
07. Simon OShine - Miss You (Original Mix) [Defcon Recordings]
08. Evgeny Bardyuzha & Soarsweep ft Manon Polare - Ceaseless (Poshout Club Mix) [Ergonomic Music]
09. Jective - Mirrors (Original Mix) [Silent Shore Records]
10. Danyella & Daviper - From Malta To Germany (Mindful Innovations Remix) [Trance All-Stars Records]

Hour 2: Akira Kayosa:

1. Colonial One ft Isa Bell - Always On My Minds (Cordonnier Mix) (Alter Ego Pure)
2. Reminder & Cressida - Lucid (Ronski Speed Mix) (Afterglow Records)
3. Sunny Lax & Solex - Out Of This World (Mike Koglin Mix) (Anjunabeats)
4. Filo & Peri ft Audrey Gallagher - This Night (Alex Morph Mix) (Vandit Records)
5. Estiva - Foreverland (Original Mix) (Enhanced)
6. The Thrillseekers - Synaesthsia (Alex Morph Mix)
7. Signum ft Kate Louise Smith - Liberate (David Forbes Mix) (Soundpiercing)
8. Nenes & Pascal Feliz - Platinum (Ben Gold Mix) (High Contrast)
9. Akira Kayosa & Michael Dow pres Alderney - Unbreakable (Original Mix) (First State Music)
10. Fafaq - Carimucho (Original Mix) (High Contrast Nu Breed)
11. Jonathan Stone - Pandorum (Original Mix) (High Contrast Nu Breed)
12. Ferry Corsten pres Eon - Pocket Damage (Juventa Mix) (Flashover Music) 