Gone with the wind [DVDrip ITA ENG Ac3] TNT Village

Dual audio: #1 Italian #2 English

.: Release Originale :.
 
http://forum.tntvillage.scambioetico.org/tntforum/index.php?showtopic=78546

.: Plot :.

Scarlett is a woman who can deal with a nation at war, Atlanta burning, the Union Army carrying off everything from her beloved Tara, the carpetbaggers who arrive after the war. Scarlett is beautiful. She has vitality. But Ashley, the man she has wanted for so long, is going to marry his placid cousin, Melanie. Mammy warns Scarlett to behave herself at the party at Twelve Oaks. There is a new man there that day, the day the Civil War begins. Rhett Butler. Scarlett does not know he is in the room when she pleads with Ashley to choose her instead of Melanie.

.: Trama :.

Nella Georgia del 1861, attraverso le peripezie e i matrimoni di un'egocentrica fanciulla del Sud, Rossella O'Hara, viene dipinto un affresco melodrammatico ma spettacolare e coinvolgente della guerra di Secessione, Il film ha battuto tutti i record di spettatori paganti nella storia del cinema e riesce ad avere ancora grandi ascolti televisivi. La frase che la protagonista pronuncia alla fine del film: "Ci penserÃ² domani. Dopotutto, domani Ã¨ un altro giorno" Ã¨ divenuta proverbiale.

.: Cover :.
 
http://img847.imageshack.us/img847/2787/2021c.jpg

.: Crediti :.

Titolo Italiano: Via col vento
Paese 	Stati Uniti d'America
Anno 	1939
Genere 	Drammatico, Epico
Regia 	Victor Fleming
Soggetto 	Margaret Mitchell
Sceneggiatura 	Sidney Howard
Produttore 	David O. Selznick
Casa di produzione 	Metro-Goldwyn-Mayer
Fotografia 	Ernest Haller
Montaggio 	Hal C. Kern
Effetti speciali 	Jack Cosgrove
Musiche 	Max Steiner
Scenografia 	William Cameron Menzies, Lyle R. Wheeler

Cast:    Vivien Leigh: Rossella O'Hara (Scarlett O'Hara)
    Clark Gable: Rhett Butler
    Olivia de Havilland: Melania Hamilton (Melanie Hamilton)
    Leslie Howard: Ashley Wilkes
    Hattie McDaniel: Mami (Mammy)
    Thomas Mitchell: Gerald O'Hara
    Barbara O'Neil: Ellen O'Hara
    Laura Hope Crews: Zia Pittypat
    Ona Munson: Bella Watling (Belle Watling)
    Harry Davenport: Dott. Meade
    Leona Roberts: Sig.ra Carolina Meade
    Butterfly McQueen: Prissy
    Victor Jory: Jonas Wilkerson
    Everett Brown: Sam (Big Sam)
    Howard C. Hickman: John Wilkes
    Alicia Rhett: Lydia Wilkes (India Wilkes)
    George Reeves: Stuart Tarlenton
    Fred Crane: Brent Tarlenton
    Evelyn Keyes: Susele O'Hara (Suellen O'Hara)
    Ann Rutherford: Carreen O'Hara
    Rand Brooks: Carlo Hamilton (Charles Hamilton)
    Carroll Nye: Franco Kennedy (Frank Kennedy)
    Jane Darwell: Sig.ra Merriwether
    Ward Bond: Comandante nordista

0=============================0

.: Info Ripping :.

Nome Codec Video: XviD 1.1.0 Final
Larghezza Frame: 544
Altezza frame: 384
Display Aspect Ratio: 1.417
FPS: 25.000
Video Bitrate: 965 kbps
QF: 0.185

Codec audio: AC3
Freq.audio: 48000 Hz
Bitrate: 384 kbps
Tipo: CBR
Canali: 6