Album: Discoparade estate 2000
Artist: Various
Channels: Stereo
Samplerate: 44100 Hz
Bitrate: 320 kbps
Audio Codec: Ogg Vorbis

TRACKLIST

Gaya' - Never Meet

Tony Sweat - Sex Machine (Get Up I Feel Like Being Like A Sex Machine)

Paps N Skar - Turn Around

2 Thousand - Emotion
               Featuring - D.D. Klein

French Affair - My Heart Goes Boom (Ladidada)

Miranda - Eldorado (Album Version)

Mabel - Bum Bum

Soundlovers, The - Wonderful Life (Short Party)

Eiffel 65 - Too Much Of Heaven

Consilio - The Colours Of Love

Carolina Marquez - Super DJ

Bamble B - Crime Of Passion

4 Factory - Give Me More

Noname - Off

Regina - You And Me (Mosso Anthem Radio Edit)
           Remix [Uncredited] - Mosso

Players, The - Ale' Oh-Oh (Stadio Cut)

L@ra - La La Love You

Koala - Eternity Is Past
         Featuring - DJ Dave

Tofunk - Alright ! (Make Me Feel)

House Of Glass - Disco Down (The Boogie)
                  Featuring - Giorgio Giordano

DJ Dado - Where Are You? (Molella & Phil Jay Happy Edit)
           Remix [Uncredited] - Molella & Phil Jay

Mash - Rock The Disco (Encoder Mix)

Brahama / Rockets - Future Woman (Future Love)

Floorfilla - Anthem #3

More - Around The World

E.Magic - Go!
           Featuring - Nancy

Fifty Fifty - I Want You

Flying Over Manhattan - It's Love

Lady Violet - Beautiful World

Urban - The Way

Gigi D'Agostino - L'Amour Toujours

Potatoes & Tomatoes - Keep Your Feeling On (Radio Edit)

Countermove - Unbelievable (Radio Edit)

Silvie Lorraine - You Are My Life

Voice 2 Voice - Stop

DJ Visage - Der Totale Beat