TÃTULO ORIGINAL 	The Claim
AÃ‘O 	
2000 	
DURACIÃ“N 	
120 min. 	  Trailers/VÃ­deos
PAÃS 	
[Reino Unido] 	 
DIRECTOR 	Michael Winterbottom
GUIÃ“N 	Frank Cottrell Boyce (Novela: Thomas Hardy)
MÃšSICA 	Michael Nyman
FOTOGRAFÃA 	Alwin Kuchler (AKA Alwin H. Kuchler)
REPARTO 	Wes Bentley, Milla Jovovich, Nastassja Kinski, Peter Mullan, Sarah Polley, Marie Brassard, Shirley Henderson
PRODUCTORA 	United Artists Films / Pathe Pictures presentan una producciÃ³n de Revolution Films / DB Entertainment / GrÃ³svenor Park
WEB OFICIAL 	http://www.theclaimmovie.com/
GÃ‰NERO 	Western
SINOPSIS 	1867. Fiebre del oro en California. Kingdom Come es una pequeÃ±a ciudad minera dominada por Daniel Dillon. La inminente construcciÃ³n del ferrocarril que atravesarÃ¡ la poblaciÃ³n representa una amenaza para su poder. Pero lo que verdaderamente perturba la vida de Dillon es la llegada a la ciudad de dos mujeres que remueven en su memoria terribles hechos del pasado. (FILMAFFINITY)

CRÃTICAS 	----------------------------------------
El siempre arriesgado Winterbottom intenta en esta pelÃ­cula combinar el drama mÃ¡s puro -secretos ocultos durante aÃ±os, sentimientos encontrados, pasiones nuevas- con el western de estirpe mÃ¡s recia. El resultado es una pelÃ­cula singular y ambigua, que resulta mÃ¡s atractiva desde un punto de vista intelectual -en tanto que propuesta de renovaciÃ³n de un gÃ©nero por la vÃ­a del realismo, en la senda abierta por la magnÃ­fica "Sin perdÃ³n"- que emocional. La frialdad que respira la cinta, fruto menos de las soberbias y heladas localizaciones que del estilo quizÃ¡ para la ocasiÃ³n excesivamente "moderno" de Winterbottom -planos muy cortos, montaje sintÃ©tico, mÃºsica de Nyman- acaba por contagiarse al espectador. Falta ademÃ¡s la Ã©pica inherente al gÃ©nero, de modo que la pelÃ­cula es antes un drama ambientado en el Oeste americano que un western. La pelÃ­cula, como casi todas las de su director, es sÃ³lida y tiene interÃ©s -amÃ©n de estar sostenida por excelentes actores-, pero del director de la conmovedora "Wonderland" siempre esperamos mÃ¡s. (Daniel Andreas: FILMAFFINITY)
----------------------------------------
"ExtraÃ±o y vigoroso western (...) insÃ³lito, radical y desatado, una mezcla de gran pureza entre vigor Ã©pico y melodramÃ¡tico. EstÃ¡ compuesto por extraordinaria audacia formal (...) Cine vivo y noble, gran cine" (Ãngel Fdez. Santos: Diario El PaÃ­s) 