The Voice Of Holland - The Songs (2CD) (2010)

 
 
  Op deze dubbel-cd staan 20 volledige nummers (en een bonustrack) die de toptalenten in de immens populaire Live Shows van The Voice Of Holland hebben gezongen. Dus geen korte fragmenten zoals op televisie, maar de complete studio opnamen van alle bekende nummers, gezongen door jouw favoriete kandidaten!

De enige echte originele CD!!! 
 HQ covers




Disk 1
1. Lenny Keylard - Could You Be Loved
2. Joan Franka - Foolish Games
3. Pearl Josefzoon - Bad Boys
4. Shemsi Mushkolaj - Tattoo
5. Davy / Joshua - Dj Got Us Falling In Love
6. Kim De Boer - Cry Me A River
7. Kevin Okkema - I Don't Want To Be
8. Bart Van Overbeek - When I Get You Alone
9. Leonie Meijer - Just Say Yes
10. Shary-An Nivillac - Just Like A Pill

Disk 2
1. Ben Saunders - If You Don't Know Me By Now
2. Anne Hoogendoorn - Just A Girl
3. Nigel Brown - Just The Way You Are
4. Johnny Rosenberg - Another Day
5. Jennifer Ewbank - Can't Get You Out Of My Head
6. Nyssina Swerissen - Sweet Dreams
7. Charlotte Ten Brink - Apologize
8. Raffaella Paton - Bad Romance
9. Meike Van Der Veer - All The Man I Need
10. Ray Klaassen - You're Beautiful
11. The Voice Of Holland Leader (Bonustrack)

Spotinformatie 
Categorie : Geluid 
Formaat : Lossless 
Bron : CD
 
Bitrate : 320 kbit
Lossless
 
Genre : Pop

DE RETAIL COVERS(FRONT,BACK,DISC) ZITTEN ER OOK BIJ!!! 



Thanks : catweazel

TBS

black-sam