TÃTULO ORIGINAL 	L\'adversaire
AÃ‘O 	
2002 	
DURACIÃ“N 	
129 min. 	  Sugerir trailer/vÃ­deo
PAÃS 	
[Francia] 	 
DIRECTOR 	Nicole Garcia
GUIÃ“N 	Jacques Fieschi, FrÃ©dÃ©ric BÃ©lier-Garcia, Nicole Garcia (Novela: Emmanuel CarrÃ¨re)
MÃšSICA 	Angelo Badalamenti
FOTOGRAFÃA 	Jean-Marc Fabre
REPARTO 	Daniel Auteuil, GÃ©raldine Pailhas, FranÃ§ois Cluzet, Emmanuelle Devos, Bernard Fresson, FranÃ§ois BerlÃ©and
PRODUCTORA 	CoproducciÃ³n Francia-EspaÃ±a-Suiza; Les Films Alain Sarde / France 3 CinÃ©ma / VÃ©ga Film / Vertigo Films
PREMIOS 	2002: 5 Nominaciones a los Premios CÃ©sar
GÃ‰NERO 	Drama. Thriller
SINOPSIS 	Basada en hechos reales, \"El adversario\" narra la historia de Jean Claude Roman, aparente marido ideal, amante perfecto, padre ejemplar... e insospechado asesino. (FILMAFFINITY)

CRÃTICAS 	----------------------------------------
\"Un quiero y no puedo\" (Ãngel Fdez. Santos: Diario El PaÃ­s)
----------------------------------------
\"TerrorÃ­fica pelÃ­cula\" (Borja Hermoso: Diario El Mundo)
----------------------------------------