New Liveset from Bass-FRK, made: 23-02-2011.
14 Ultimate Hardstyle tracks in one mix.

128 KBps
Total mix: 57:51 min. 








1.  Bang the Bass (Original Mix)	                Zany & Brennan Heart								
2.  Paranormal Activites	                        Kodex									
3.  Music Made Addict (Headhunterz & Wildstylez Rmx)	D-Block & S-Te-Fan								
4.  Feel My Fire	                                Ran-D									
5.  Old Vs New	                                        Unifite								
6.  Live Without Existing	                        Second Identity									
7.  The Solution	                                Unifite									
8.  On the Go	                                        Max Enforcer & Frontliner									
9.  Sound Of The Machine	                        The Machine									
10. More and More	                                Maxter									
11. Shut Up (Original Mix)	                     The Pitcher Ft. Noisecontrollers								
12. Just A Track	                                Frontliner								
13. Can't Fail (Original Mix)	                        Toneshifterz								
14. You're Next (Original Mix)	                        Jack of Sound					






Hope you enjoy :)

Keep it Loud!!
