
Release: The Maverick Queen [Barbara Stanwyck] (1956) DVDRip Oldies
Title in Brazil: AtÃ© a Ãšltima Bala 
Uploader:	labok
Size: 600 MB
Genre: Western
Language: English
Runtime: 90 mins
ResoluÃ§Ã£o: 672 x 384
Video Codec: XVID
Subtittles: No
Audio Codec: MP3
Taxa de Biltrate: 128 Kbps 
IMDB Rating: 5,7 (awaiting 147 users)
IMDB Link: http://www.imdb.com/title/tt0049487/
Directed By: Joseph Kane

Starring:  

Barbara Stanwyck - Kit Banion 
Mary Murphy - Lucy Lee 
Wallace Ford - Jamie 
John Doucette - Loudmouth 
Barry Sullivan - Jeff Younger 
Pierre Watkin - McMillan 
Taylor Holmes - Pete Callaher 
Scott Brady - Sundance 
Howard Petrie - Butch Cassidy 
Emile Meyer - Malone 

Synopis: 

A Pinkerton detective goes undercover to infiltrate a gang of thieves whose boss is a feisty lady saloonkeeper. Complications ensue. 

Sinopse Pt Br:

Baseado em um romance de Cinza Zane, publicado a mais de uma dÃ©cada apÃ³s a morte do autor, "A Rainha Maverick", com Barbara Stanwyck no papel-tÃ­tulo. Como chefe da gangue chamada The Wild Bunch, Kit Banion (Stanwyck) causa estragos nos bancos e estradas de ferro do Ocidente. Pinkerton, detetive Jeff (Barry Sullivan) se infiltra na gangue, e se apaixona por Kit ao longo do caminho. Inevitavelmente, um dos personagens principais expira outros braÃ§os, trazendo este emocionante oeste a uma conclusÃ£o triste.
