
* Athabasca - Athabasca
* Bereneiland - Bear Island
* Booreiland X-13 - Fear is the key
* Circus - Circus
* De eenzame zee - The lonely sea
* De genadelozen - Where eagles dare
* De gouden poort - The Golden Gate
* De laatste grens - The last frontier
* De zeeheks - Seawitch
* De zwarte kruisvaarder - The dark crusader
* Het Satanskruid - The satan bug
* Hoog water - Floodgate
* Karavaan naar VaccarÃ¨s - Caravan to VaccarÃ¨s
* Komplot in CaliforniÃ« - Goodbye California
* Komplot op zee - Golden rendez-vous
* Nacht zonder einde - Night without end
* Ondergang om middernacht - When eight bells toll
* Ontsnapt langs Krakatau - South by Java Head
* Partizanen - Partisans
* Poolbasis Zebra - Ice Station Zebra
* Poppen aan een touwtje - Puppet on a chain
* Rivier des doods - River of death
* San Andreas - San Andreas
* Santorini - Santorini
* Stoptrein naar Fort Humboldt - Breakheart pass
* Toren gegijzeld - Hostage tower
* Valse start - The way to dusty death
* Vliegtuig in vlammen - Airforce One is down
* Zr.ms. Ulysses - H.M.S. Ulysses
Navarone


De kanonnen van Navarone - The guns of Navarone

Commando Navarone - Force 10 from Navarone

De mannen van Navarone - Storm force from Navarone

Dreiging van Navarone - Thunderbolt from Navarone

De Navarone-boeken van Sam Llewellyn zijn vervolgen op De kanonnen van Navarone en Commando Navarone. Sam Llewellyn kreeg na MacLeans dood toestemming van de erven om de hoofdpersonen van de Navarone-thrillers nieuw leven in te blazen.

En nog een aantal. :D 



NLT IS TERUG KOM SNEL NAAR 
 
http://www.nlt-release.nl 

By Linday