My first torrent! 

The Sound Of Dubstep Darker - Ministry Of Sound
MP3's not sure the bit rate



1. Natural Disaster(Laidback Luke Vs Example)(Skream Remix)  Laidback Luke   4:42	     	
2. Gorilla Flex (Roksonix King Kong Remix)	               FuntCase	     5:22		
3. Praise You (JFB Remix)	                             Fatboy Slim     5:37
4. Badness	                                               Zed Bias	     5:36		
5. Follow U (Xilent Remix)	                                Yogi	     4:56
6. Bright Lights (Joker Remix)	                                 Die	     5:09	
7. Solace One	                                          Foreign Beggars    4:36	
8. Some Way Through This (Plastician & Skream Remix)	    Black Ghosts     5:51		  9. Dem Na Like Me (Subscape Dub)	                    The Qemists	     5:18	
10. Let's Go	                                              Roksonix	     4:56		
11. Killing Me	                                               Dodge	     4:50		
12. Pirate Hooker	                                       Zomboy	     3:40		
13. Rise Of The Idiots (Funtcase Remix)                 	Skism	     6:10	
14. Under The Bed	                                      Skeptiks	     5:40		
15. Surge (16bit Remix)                                       Amon Tobin     5:02		
16. Ruff (Coven Remix)	                                       Teknian	     5:49		
17. Killer	                                                Apollo	     4:36		
18. Filth [Explicit]	                                         Dodge	     4:23		
19. Remake	                                                 Kaney	     3:42		
20. Something Out There                                   	JFB	     4:41		
21. I Need A Touch	                                      Sashaslay	     3:26		
22. Running Against The Clock	                                 Apollo	     4:09		 	
23. Soldier	                                             Refix	     5:42		
24. Open	                                                Chrispy	     6:03		
25. Renegade (The Qemists VIP)	                           The Qemists	     5:01		
26. Evaporate	                                               Skit	     3:53		
27. Gullystep	                                            Gully Floss      4:07	