TÃTULO ORIGINAL 	La finestra di fronte
AÃ‘O 	
2003 	
DURACIÃ“N 	
106 min. 	  Trailers/VÃ­deos
PAÃS 	
[Italia] 	 
DIRECTOR 	Ferzan Ozpetek
GUIÃ“N 	Ferzan Ozpetek & Gianni Romoli
MÃšSICA 	Andrea Guerra
FOTOGRAFÃA 	Gianfilippo Corticelli
REPARTO 	Giovanna Mezzogiorno, Massimo Girotti, Raoul Bova, Filippo Nigro, Serra Yilmaz, Maria Grazia Bon, Massimo Poggio, Ivan Bacchi
PRODUCTORA 	CoproducciÃ³n Italia-GB-TurquÃ­a-Portugal
PREMIOS 	2002: Premios David di Donatello: 4 premios, incluyendo Mejor pelÃ­cula. 11 nominaciones
GÃ‰NERO 	Drama. Romance | Drama romÃ¡ntico
SINOPSIS 	Giovanna lleva nueve aÃ±os felizmente casada. Trabaja en una granja de pollos, cocina pasteles para un cafÃ© local y cuida niÃ±os. Todo va bien hasta que su marido lleva a casa a un hombre amnÃ©sico que ha encontrado en la calle. En su intento de ayudarle, Giovanna pasa cada vez mÃ¡s tiempo con Ã©l y, poco a poco, va descubriendo su misterioso pasado: un nÃºmero tatuado en su antebrazo, su experiencia en el mundo de la pastelerÃ­a, un nombre: Simone... Cada vez mÃ¡s irritada con la pasividad de su marido, empieza a fijarse en el vecino de enfrente, en el que pone la esperanza de algo nuevo y excitante en su vida. (FILMAFFINITY)

CRÃTICAS 	----------------------------------------
Obtuvo un gran Ã©xito de crÃ­tica y pÃºblico en Italia, llevÃ¡ndose 5 premios David di Donatello, incluyendo mejor pelÃ­cula, mejor actriz, mejor actor y mejor banda sonora. (FILMAFFINITY)
----------------------------------------
"Drama sÃ³lido, aunque con algunas concesiones a la facilidad y algunas trampas de guiÃ³n (...) MÃ¡s allÃ¡ de pequeÃ±as debilidades, se deja ver con agrado" (M. Torreiro: Diario El PaÃ­s)
----------------------------------------
"Ozpetek acierta en el dibujo de sus dos personajes centrales (...) la pelÃ­cula nos habla de la felicidad como de un acto de egoÃ­smo" (Federico MarÃ­n BellÃ³n: Diario ABC) 