Time Life Music - Lifetime of Romance 2CD set - 
"Some Enchanted Evening" - all mp3s at 192k bitrate

CD1 
Bobby Vinton - Blue On Blue
Debby Boone - You Light Up My Life
Eddy Arnold - Make The World Go Away
Elvis Presley with The Jordanaires - Are You Lonesome Tonight
Floyd Cramer - Last Date
Gale Garnett - We'll Sing In The Sunshine
Gene Pitney - Only Love Can Break A Heart
Henry Mancini Orchestra and Chorus - Moon River 
Jim Reeves - He'll Have To Go
John Denver - I'm Sorry
Judy Collins - Send In The Clowns
Melissa Manchester - Through The Eyes Of Love 
Nino Tempo and April Stevens - Deep Purple
Sammy Davis Jr. - What Kind Of Fool Am I
The Platters - Twilight Time

CD2
Andy Williams - Can't Get Use to Losing You
B. J. Thomas - Raindrops Keep Fallin' on My Head
Bobby Darin - Beyond the Sea
Ed Ames - Try to Remember 
Elvis Presley with The Jordanaires - It's Now or Never
Emilio Pericoli - Al Di La'
Harry Belafonte - Jamacia Farewell
Hugo Winterhalter and His Orchestra - Canadian Sunset
Nilsson - Eveybody's Talkin'
Perry Como - It's Impossible
Perry Como - Some Enchanted Evening 
Ray Stevens - Everything is Beautiful
Roger Whittaker - The Last Farewell
The 5th Dimension - (Last Night) I Didn't Get to Sleep at All
Tony Orlando & Dawn - Tie a Yellow Ribbon 'Round the Ole Oak Tree


enjoy!

Michael Rizzo Chessman
musicfromrizzo