Ace Of Base -  All For You ( Paul Johns Summer Remix )
Airdrops - Dancing Crazy (FM Cut)
Alice Deejay - Better Off Alone (Remastered 1999 Version)
Anda Adam ft. Ibrahim Celik - Feel (Radio Mix)
Aroma feat. Lyck - Summer Of Love (Radio Edit)
Arsenie Feat. Elena Knyazeva - My Heart (Radio Edit)

Bassline - Never Be Alone
Britney Spears - Burning Up 2011

Chris Dave - I Have A Dream (Radio Edit) (by Edward Maya)
Claude - Cant Get Enough (Enrique Iglesias)

DeepSystem - Summer Time (Radio Edit)
Delia - Dale (Radio Edit)
Delyno feat. Looloo - Let Me Feel You (Radio Edit)
Desislava - I Like
DJ Antoine feat. Tom Dice - Sunlight (DJ Antoine vs. Mad Mark Deluxe Edit)
Dj Gun - LLP Promotional Mix (Iunie 2011)
Dj Power - Inside Me (Radio Edit)
Dj Robert Georgescu & Lara feat. Da Fleiva - I Feel 2011 (Radio Edit)

Faydee - Psycho (Radio Edit)
Flo Rida - Kiss The Sky (Radio Edit)
Flo Rida feat. Dwaine - Kiss The Sky
Flo-Rida - Good Feelin
Free Deejays - Around The World (Radio Edit)
Free Deejays - Vara Asta Este ZU 2011 (Around the World)

Geo Da Silva ft. Royaal & Tony Tomas - Param Pam Pam (Radio Edit)
Geo Da Silva With Saftik And Royaal - How Many Shots (Radio Edit)

Honey - Runaway 2011

INNA - Club Rocker (Extended Version)
INNA - Grenade
INNA feat. Juan Magan - Un Momento

Iyaz - Last Forever (Radio Edit)

JLS Feat. DEV - She Makes Me Wanna (CDQ)

Ke$ha vs. Britney Spears - Going TiK ToK 4 U
Kesha - Tease Me

Kevin Borg - Sunrise (Radio Version)
Kittens - Bloody Marry (Radio Edit)

Lady GaGa - The Edge Of Glory (Cahill Major Radio Edit)
Lika - Coturo
Liviu Hodor & Mona - Sweet Love

Mattyas - Mi  Amor (Radio Edit)
Maxigroove - Alone (Radio Mix)
Medina - For Altid

Nick Carter - Coma

Pitbull feat. Enrique Iglesias - Come N Go
Pitbull feat. Marc Anthony - Rain Over Me
Pitbull Feat. Red Foo Vein & David Rush - Took My Love
Play & Win - Ya BB Americano (Jay Amato SunFlow Mix 2011)

Romeo Cooper Feat Megane - Je Veux (Radio Edit)
Roxana Nemes - Just Sex (Dj Yaang & Aisa Radio Remix)

Sceptik Deejay - Yo Te QueroSentir La Pasion (Radio Edit)
Selena Gomez & The Scene - Love You Like A Love Song (Single Edit)
Selena Gomez & The Scene - My Dilemma
Simon De Jano feat Kim Lukas - One More Day (Video Edit)
Simon From Deep Divas feat Goody - Disco Dancer (Simon Original Radio Mix)
Sistem feat. Deepcentral - I Fucked Up

Topmodelz - My Paradise (Extended Mix)

Verona - Hey Boy (Radio Edit)
Victoria S - Voyeur

Whigfield - C'est Cool

