TÃTULO ORIGINAL 	People I Know
AÃ‘O 	
2003 	
DURACIÃ“N 	
95 min. 	  Trailers/VÃ­deos
PAÃS 	
[Estados Unidos] 	 
DIRECTOR 	Daniel Algrant
GUIÃ“N 	Jon Robin Baitz
MÃšSICA 	Terence Blanchard
FOTOGRAFÃA 	Peter Deming
REPARTO 	Al Pacino, Kim Basinger, TÃ©a Leoni, Ryan O'Neal, Richard Schiff, Sophie Dahl, Bill Nunn, Robert Klein, Mark Webber, Paulina Porizkova
PRODUCTORA 	Miramax
GÃ‰NERO 	Drama
SINOPSIS 	Eli Wurman, un experto en relaciones pÃºblicas, cuyos dÃ­as de gloria se remontan al pasado, se halla perdido en un marasmo de prensa rosa, celebridades y polÃ­tica. Debido a su aficiÃ³n a mezclar alcohol y barbitÃºricos, su instinto y sus sentidos estÃ¡n mÃ¡s bien adormecidos, pero no hay nada que pueda quitarle la triste sensaciÃ³n de que ha llevado una existencia superficial. Con el tiempo su lista de clientes se ha reducido a solo uno, asÃ­ que llena su agenda haciendo favores a viejos amigos. Durante una interminable noche, pondrÃ¡ en juego su salud, su carrera y su vida social a fin de preparar un acto benÃ©fico en favor de ciertos refugiados africanos; por otra parte, se zambulle en un peligroso mundo de drogas ilegales, sucias maniobras polÃ­ticas y sexo cuando su famoso cliente se ve envuelto en un escÃ¡ndalo. (FILMAFFINITY)

CRÃTICAS 	----------------------------------------
Es inusual que los americanos, inventores de lo "polÃ­ticamente correcto", hayan realizado a los pocos meses de la tragedia del 11 de Septiembre una pelÃ­cula tan inmisericorde con la ciudad de Nueva York, con su gente, con su forma de vivir, relacionarse y trabajar. Digo esto porque, ademÃ¡s del mejor Al Pacino de los Ãºltimos aÃ±os, este interesante drama descubre sin piedad a su verdadera protagonista: la ciudad neoyorquina, hoy herida, que muestra su fauna polÃ­tica y social llena de gente cruel, tramposa y amoral. Tan cruel, tramposa y amoral que ni siquiera a un decadente, cansado y autodestructivo relaciones pÃºblicas le dejan el tiempo suficiente para que su ritmo de vida le pase factura. (Pablo Kurt: FILMAFFINITY)
----------------------------------------
"La mejor interpretaciÃ³n que le he visto en bastante tiempo al frecuentemente irritante Al Pacino. (...) una pelÃ­cula curiosa a ratos y que la sostiene plano a plano Pacino." (Carlos Boyero: Diario El Mundo)
----------------------------------------
"Este rutinario drama crece gracias a la explosiva labor de Al Pacino, que llena de vida al relaciones pÃºblicas" (Miguel Ãngel Palomo: Diario El PaÃ­s) 