Jay and Silent Bob Strike Back (2001) [DVDrip ITA] TNT Village

.: Release Originale :.
 
http://forum.tntvillage.scambioetico.org/tntforum/index.php?showtopic=59486

.: Trama :.

Jay & Silent Bob scoprono che il loro vecchio amico Banky Edwards li ha traditi. Sembra, infatti, che questi si sia trasferito ad Hollywood per produrre un film tratto da un libro di fumetti sui loro alter ego Bluntman & Chronic (parodia di Batman e Robin) ed interpretato da due popolari attori hollywoodiani. Sconvolti, i very Jay & Silent Bob decidono di attraversare tutti gli Stati Uniti per arrivare ad Hollywood in tempo per sabotare la produzione del film...

.: Cover :.
 
http://img247.imageshack.us/img247/5460/jayesilentbob5pm.jpg

.: Crediti :.

Titolo originale 	Jay and Silent Bob Strike Back
Titolo italiano: Jay and Silent Bob Fermate Hollywood
Paese 	USA
Anno 	2001
Genere 	commedia
Regia 	Kevin Smith
Soggetto 	Kevin Smith
Sceneggiatura 	Kevin Smith
Produttore 	Kevin Smith
Effetti speciali 	Mark Alfrey
Musiche 	Luke Esterkyn, Greg Gueldner, John McDermott
Scenografia 	Jeff MacIntyre, Douglas A. Mowat

Cast:    Jason Mewes: Jay
    Kevin Smith: Silent Bob
    Shannon Elizabeth: Justice
    Eliza Dushku: Sissy
    Ali Larter: Chrissy
    Jennifer Schwalbach Smith: Missy
    Will Ferrell: Federal Wildlife Marshal Willenholly
    Jason Lee: Brodie Bruce/Banky Edwards
    Chris Rock: Chaka Luther King
    Ben Affleck: Holden McNeil / se stesso
    Matt Damon: Se stesso
    Jeff Anderson: Randal Graves
    Brian O'Halloran: Dante Hicks
    Judd Nelson: Sceriffo
    Jason Biggs: Se stesso/Silent Bob
    James Van Der Beek: Se stesso/Jay
    Seann William Scott: Breth
    Shannen Doherty: Se stessa/Kate Kessler
    Jamie Kennedy: Assistente di Chaka
    Wes Craven: Se stesso
    Mark Hamill: Se stesso (Scassacazzi)
    Carrie Fisher: una suora
    Gus Van Sant: Se stesso
    Diedrich Bader: Guardia di sicurezza Miramax
    George Carlin: un autostoppista
    Jon Stewart: Reg Hartner
    Tracy Morgan: Pumpkin Escobar
    Scott William Winters: Se stesso/Clark

0=============================0

.: Info Ripping :.

Dimensione........: 682 MB
Durata............: 01:39:03

Video Codec.......: DivX 3 Low-Motion
Video Bitrate.....: 822 kb/s
Risoluzione.......: 640 x 272
FPS (Frames/sec)..: 24.996
QF (Frame quality): 0.189 bits/pixel

Audio Codec.......: MP3
Audio Bitrate.....: 128 kb/s (64/ch, stereo) CBR
Freq Audio........: 44100 Hz
