EnigmaT Set Rips { Cuts } - April 21st, 2011


Join my facebook page to hear my best unreleased track of the night and to download the latest unreleased electronic music  
 
http://enigmat.webhop.net

Join The EnigmaTDC Hub For Direct Downloads   
http://enigmat.webstarts.com/


Want to find a free downloadable version of any new trance or progressive house track?
Then GOGGLE the track artist and title with the word EnigmaT after it.
Spread the word about this trick to everyone in the scene!



April 21st, 2011

A.R.D.I. - Space (Hoyaa & Lunar System Remix) (Cut From Colak Set)-enTc.mp3
A.R.D.I. - Wrong Turn (Angel Ace Remix) (Cut From Angel Ace Set)-enTc.mp3
Abendstern Rigel - Hidden In The Night (Cut From Valentine Set)-enTc.mp3
Above & Beyond Feat. Richard Bedford - Thing Called Love (Burning Bridges Mix) (ASOT 500 Rip)-enTc.mp3
Air Night - 7 Days of Night (Original Mix) (Cut From Kaeno Set)-enTc.mp3
Air Night - In Beat Nights (Original Mix) (Cut From Victoria Set)-enTc.mp3
Alpha Force - Magic Island (Original Mix) (Cut From Shadows Set) (Â«â€¢Â»)-enTc.mp3
Alvaro - Cubata (Breakdown Remix) (Cut From Oakenfold Set)-enTc.mp3
Aly & Fila - Rosaires (Giuseppe Ottaviani Remix) (Set Rip)-enTc.mp3
Andy Arias & Ivan Jaime - Unknown Name (Original Mix) (Cut From Dark Soul Set)-enTc.mp3
Andy Arias - Horns Chain (Cut From Dark Soul Set)-enTc.mp3
Andy Blueman - Time To Rest (2011 Rework) (Cut From Tyas Set)-enTc.mp3
Andy Blueman - Time To Rest (Karl G. Remix) (Cut From A&F Set)-enTc.mp3
Andy Duguid Feat. Fenja - Strings (Moonbeam Remix) (-Short- Cut From Duguid Set)-enTc.mp3
Andy G - Pineapple Express (Cut From Protoculture Set)-enTc.mp3
Andy Moor vs. Mike - Spirits Pulse (Omnia Remix) (Cut From Bobina Set)-enTc.mp3
Armin van Buuren - Mirage (Alexander Popov Remix) (ASOT 500 Rip)-enTc.mp3
Artur Reimer Feat. Johannes Janzen - Polys (Cut From Dark Soul Set)-enTc.mp3
Artur Reimer Feat. Markus Janzen - One Day (Kill Minimal Remix) (Cut From Dark Soul Set)-enTc.mp3
Avalona - Forgotten Paradise (Oen Bearen Remix) (Cut From Shah Set)-enTc.mp3
Bissen - Skylands (Nouveau Intro Mix) (Cut From Bobina Set)-enTc.mp3
BT - Remember (Ideal & J-Break Remix) (Cut From Oakenfold Set)-enTc.mp3
Castaneda - Floor Control (Giuseppe Ottaviani Remix) (Set Rip)-enTc.mp3
Chase & Status Feat. Delilah - Time (Cypher Remix) (Cut From Sherry Set)-enTc.mp3
Chasing Dreams - Memory (Running Man Dream Mix) (Cut From ReOrder Set)-enTc.mp3
Christian Drost - Easy Life (Lee Canning Remix) (Cut From Victoria Set)-enTc.mp3
Christian Falero Feat. Jei - Enlevez Moi (Paul Thomas Remix) (Cut From SvD Set)-enTc.mp3
CJ Peeton - Thoughts Of The Past (Second Sine Remix) (Cut From Grube Set)-enTc.mp3
Claudia Cazacu - Maison (Cut From Bobina Set)-enTc.mp3
Conrad Winged & Ascania - Kashmir (Original Mix) (Cut From Shadows Set) (Â«â€¢Â»)-enTc.mp3
D-Mad - I Come To Her (Cut From SvD Set)-enTc.mp3
Da Hool - Meet Her At The Love Parade (Arnej Re-Dub) (ASOT 500 Rip)-enTc.mp3
Daiquiri - Himalaya (Original Mix) (Cut From Moore Set)-enTc.mp3
Danny - If Only You (Vegas Baby Remix) (Cut From Bobina Set)-enTc.mp3
Danny J Player - Milion Places (Eddie Sender Remix) (Set Rip)-enTc.mp3
David Rull - Tundelala (Original Mix) (Cut From Victoria Set)-enTc.mp3
Deep Cry - Crossing Over (Cut From Fleming Set)-enTc.mp3
Dibby Dougherty & David Young - Not Trippin (Original Mix) (Cut From Dark Soul Set)-enTc.mp3
Digital Blonde - 6 Weeks & 1 Million Years (Cut From Fleming Set)-enTc.mp3
Dominik Dudek Pres. Astral Forteness - Skyline (Cut From Thr3shold Set)-enTc.mp3
Eddie Sender & LayDee Jane - UNTITLED (Set Rip)-enTc.mp3
Eddie Sender - UNTITLED 001 (Set Rip)-enTc.mp3
Eddie Sender - UNTITLED 002 (Set Rip)-enTc.mp3
Eddie Sender - UNTITLED 003 (Set Rip)-enTc.mp3
Erik Hakansson - August (Original Mix) (Cut From Shah Set)-enTc.mp3
Ernesto vs Bastian - The Incredible Apollo (Original Mix) (Cut From EvB Set)-enTc.mp3
F.I.S.H. - Terpsichora (The Stunning Sound Remix) (Cut From Spain Set)-enTc.mp3
Fefo & Arcas - On Our Own (Cut From Dark Soul Set)-enTc.mp3
Ferry Corsten presents System F - Out Of The Blue 2011 (Luke Terry Remix) (Cut From Tyas Set)-enTc.mp3
Ferry Tayle - The Glorious Deception (Original Mix) (Cut From Tayle Set)-enTc.mp3
Fon.Leman - Binary Reaction (Original Mix) (-Short- Cut From Durand Set) (Â«â€¢Â»)-enTc.mp3
Genix - Cut Above (Cut From Ferry Set)-enTc.mp3
Genix vs. Andrew Candid - Memoria 22 (Original Mix) (Cut From Genix Set)-enTc.mp3
Henry V Feat. Sari - Reborn (Original Mix) (Cut From Shah Set)-enTc.mp3
HMC (Hannah & Miami Calling) - Taking Over Now (Giuseppe Ottaviani Remix) (Set Rip)-enTc.mp3
Ioan Gamboa - Spiral (Cut From Dark Soul Set)-enTc.mp3
Iqy - Transitions Are My Biatch (Cut From Protoculture Set)-enTc.mp3
Iqy Feat. Andy G - The Pineapples In My Throat (Cut From Protoculture Set)-enTc.mp3
Jaden Merrick - Split (Sayphonik Remix) (Cut From ReOrder Set) (Â«â€¢Â»)-enTc.mp3
JD Miller - Illegal (Original Mix) (Cut From Tasev Set)-enTc.mp3
Johnny Bee - The Choice (Original Mix) (Cut From Ronny K Set)-enTc.mp3
Jon Kong, Chris Aidy & Ana - Apollo (Cut From Grube Set)-enTc.mp3
Karybde & Scylla - Soulcatcher (Nkoder Remix) (Cut From Karybde Set)-enTc.mp3
Katsarov & Sugar DJs Feat. Jennifer Moon - Desire (Cut From Katsarov Set)-enTc.mp3
Kintar Feat. Venes - Sahara (Cut From Fleming Set)-enTc.mp3
Klopfgeister - Good Bye Goa (CJ Art Remix) (Cut From Fleming Set)-enTc.mp3
Kobana - Behind The Mirror (Cut From Julian Vincent Set)-enTc.mp3
Kosheen - Hide U (Save the Robot Remix) (Cut From Duguid Set)-enTc.mp3
Long Live Toma - The Ball & Chain (Got Him Remix) (Cut From Protoculture Set)-enTc.mp3
Marcia Juell - Calling (Mark Norman Remix) (Cut From Bobina Set)-enTc.mp3
Marco V - Sticker (Cut From SvD Set)-enTc.mp3
Marcos Feat. Emi Jarvi - Cosmic Strings (Giuseppe Ottaviani Remix) (Â«â€¢Â»)-enTc.mp3
Mark Leanings - Dropshot (Bryan Kearney Remix) (Cut From Tyas Set)-enTc.mp3
MaRLo Feat. Jano - The Island (Cut From Ferry Set)-enTc.mp3
Matt Davey - Apocalypse (Cut From Davey Set)-enTc.mp3
Maurice Lekkerkerker - Back Home (Cut From MORPH Set) (Â«â€¢Â»)-enTc.mp3
Maurice Ravel - Pavane Pour Une Infante Defunte (Angel Ace 2011 Rework) (Set Rip)-enTc.mp3
Menno de Jong - Ancient Mysteries (A Force Remix) (ASOT 500 Rip)-enTc.mp3
Michael Hutchison - Sunburn (Original Mix) (Cut From EvB Set)-enTc.mp3
Michael Jay Parker - Down Under (Cut From Ferry Set)-enTc.mp3
Michael Woods - Whatâ€™s What (Cut From Ferry Set) (Â«â€¢Â»)-enTc.mp3
Mike Levy - Illumini (Cut From Maguire Set)-enTc.mp3
Mike Levy - Optical Illusion (Cut From Maguire Set)-enTc.mp3
Montana - American Story (E-Spectro Remix) (Cut From Grube Set) (Â«â€¢Â»)-enTc.mp3
Moon Project - Moments are Forever (Astronomers Mix) (Cut From Akira Set)-enTc.mp3
Moonshade Feat. Bate - Hope (Original Vocal Mix) (Cut From Shah Set)-enTc.mp3
N&R Project - Night Shining (Aimoon Remix) (Cut From Ekman Set)-enTc.mp3
N&R Project - Night Shining (Sergey Shabanov Remix) (Cut From ReOrder Set)-enTc.mp3
N&R Project - Night Shinning (Opt-in Remix) (Cut From ReOrder Set) (Â«â€¢Â»)-enTc.mp3
Nathan Profitt - Identity (Aggressive Mix) (Cut From Karybde Set)-enTc.mp3
New Order - Blue Monday (Kent & Gian Remix) (Cut From Tyas Set)-enTc.mp3
Not Okay - Moments (Original Mix) (Cut From Duguid Set)-enTc.mp3
Pasha Effies - Sunset (Facetious Remix) (Cut From Grube Set)-enTc.mp3
Paul Miler vs Ronald de Foe - Shake It (Original Mix) (Cut From Tyas Set) (Â«â€¢Â»)-enTc.mp3
Paul Oakenfold - Tokyo (Beatman & Ludmilla Remix) (Cut From Tyas Set)-enTc.mp3
Perfect Vision - Endless Dreams (Aivem vs. Vilmo Remix) (Cut From Victoria Set)-enTc.mp3
POL - Figasa Night (Original Mix) (Cut From Bjorn Set)-enTc.mp3
Priority One - Low Winter Sun (Sulaco Remix) (Cut From Deen Set)-enTc.mp3
Priority One - Low Winter Sun (Sulaco Remix) (Cut From Ronny K Set)-enTc.mp3
Rank 1 - Airwave (Arnej Remix) (ASOT 500 Rip)-enTc.mp3
Rich Smith - Chemical Milk (Southern Side Remix) (Cut From Victoria Set)-enTc.mp3
Robert Vadney - Cafe Del Perfecto (Cut From Oakenfold Set)-enTc.mp3
Roman Degree - Gorky 88 (Original Mix) (Cut From Oakenfold Set)-enTc.mp3
Running Man & Lence - Never Look Back (Jective Remix) (Cut From ReOrder Set)-enTc.mp3
Running Man - Rise (Original Mix) (Cut From Tyas Set)-enTc.mp3
Sequentia - Tomorrow Is A Brand New Day (Cut From A&F Set)-enTc.mp3
Setrise & Matthew Nagle - Nailed It (Original Mix) (Cut From W&W Set)-enTc.mp3
SlavX - Moonlight Shadow (Original Mix) (Cut From Lazarus Set)-enTc.mp3
Steve Brian & Noel Gitman - Luna System (Original Mix) (Cut From EvB Set)-enTc.mp3
Stoneface & Terminal - Time To Wait (Original Mix) (Cut From Ferry Set)-enTc.mp3
Swanky Tunes - XOXO (Cut From SvD Set)-enTc.mp3
Tempo Giusto - Inside The Bottle (Kaeno & Denzo Remix) (Cut From Kaeno Set)-enTc.mp3
The Digital Dropouts - Here We Are (Mark Sherry vs James Allan Remix) (Set Rip) (Â«â€¢Â»)-enTc.mp3
The Scumfrog - All Goes Down (Andy Duguid Remix) (Set Rip)-enTc.mp3
Thomas Kelle - Mars Needs Lovers (Daniel Rems Remix) (TATW 368 Rip)-enTc.mp3
Thomas Kelle - Mars Needs Lovers (Oza Remix) (Cut From Grube Set)-enTc.mp3
Thr3shold Pres. Tricksters - Andromeda (Cut From Thr3shold Set)-enTc.mp3
Timur Shafiev Feat. Dasha - Thank You (Original Mix) (Cut From Andi Set)-enTc.mp3
Trane & Divinevox - Silent Sea (Running Man Remix) (Cut From Saux Set)-enTc.mp3
Tritonal Feat. Meredith Call - Broken Down (Boyan & Boyer Intro Rmx) (Cut From EvB Set)-enTc.mp3
UCast - Sunburn (Original Mix) (Cut From Suzy Set)-enTc.mp3
Undercontrol - Bubbles (Underlift Remix) (Cut From Spain Set)-enTc.mp3
Undertech & Solar Paradise - Light Day (Nomosk Remix) (Cut From Angel Ace Set)-enTc.mp3
Undertech - Light Day (Time2Rest Remix) (Cut From Electribe Set)-enTc.mp3
UNKNOWN - UNTITLED 001 (Eddie Sender Remix) (Set Rip)-enTc.mp3
UNKNOWN - UNTITLED 002 (Eddie Sender Remix) (Set Rip)-enTc.mp3
Vascotia - Calibro (Ferry Tayle Remix) (Cut From Tayle Set)-enTc.mp3
Vincent De Jager - When The Tide Comes Up (Viegel Remix) (Cut From Shah Set)-enTc.mp3
W&W - Operation AK47 (Arnej Re-Acidification) (ASOT 500 Rip)-enTc.mp3
Weepee - Summer (Club Mix) (Cut From Duguid Set)-enTc.mp3
Will Gold - Empty Promise 2011 (Original Mix) (Cut From EvB Set)-enTc.mp3
William Daniel - Type R (Will Atkinson Remix) (ASOT 504 Rip)-enTc.mp3
Zaa Feat. Jennifer Hershman - All Over Again (DJ Darq Remix) (Cut From Nazlioglu Set)-enTc.mp3
Biotones & Alexander Byrka - Neverending Dreams (Nkoder Remix) (Cut From O'Neil Set)-enTc.mp3
