Suzy Solar
Solar Power Sessions 479
Guest: Brian Benning aka LIL'B

Quality: mp3@256
Release: 18.12.2010
Genre: Trance Uplifting
Source: Radio http://puresound.fm/
Official Suzy Website: http://suzysolar.com/
Ripper: Azumi

Tracklist:

Hour 1: Suzy Solar:

01. Temple One - Feel For You (Original Mix) [Enhanced Recordings]
02. Danny Powers - Lost (Original Mix) [Kill The Lights]
03. Faruk Sabanci - The You In Me (Tech Mix) [Mondo Records]
04. Estigma ft Irena Love - Cinnamon Sunday (Estigmaâ€™s Uplifting Mix) [Harmonic Breeze Recordings]
05. C-Systems - Daylight (Trance Arts Remix) [Unearthed Red]
06. Defcon Audio - Theme From Defcon (Sulaco Remix) [Defcon Recordings]
07. Matt Davey - Back In The Day (Estigma Remix) [Nu Depth Recordings]
08. John Askew - Intimate Strangers (Aly & Fila Remix) [FSOE Recordings]
09. Suncatcher vs Pizz@dox - Remember The Youthful Years (Mohamed Ragab Remix) [FSOE Recordings]
10. Med vs Neil Bamford - Last Stand (Arctic Moon Remix) [Infrasonic Recordings]

Hour 2: Lil B:

1. Tydi ft Tania Zygar - vanilla (original mix) AVA recordings
2. Robert Nickson - We wont forget - Arty Remix - 405
3. Julie Thompson - Shine - Rafael Frost remix
4. Smart Apes - One Day You Won't See the Sunrise - Original mix (Smu(th)
5. Tritonal - Audio Rush - Tritonal rework - Fraction Records
6. Phuture Sound - Eternal Gravity - Original mix - Infrasonic Records
7. Indecent Noise - Tri Stars (Nick Sentience mix) NTR Blue
8. Interstate vs Tyler Michaud ft Jessy Greene - Junkie (Heatbeat Remix) Vandit records
9. Timo Pralle - White Clouds - Thomas Datt Pres Asedo Remix Perceptive Records
10.Arty - The Wonder - Nitrous Oxide Remix
11.Sequentia - Don't Surrender - Arty Remix - Afterglow recordings

Enjoy the high Quality ;) 
