TÃTULO ORIGINAL 	Secretary
AÃ‘O 	
2002 	
DURACIÃ“N 	
111 min. 	  Trailers/VÃ­deos
PAÃS 	
[Estados Unidos] 	  SecciÃ³n visual
DIRECTOR 	Steven Shainberg
GUIÃ“N 	Erin Cressida Wilson
MÃšSICA 	Angelo Badalamenti
FOTOGRAFÃA 	Steve Fierberg
REPARTO 	James Spader, Maggie Gyllenhaal, Jeremy Davies, Lesley Ann Warren, Stephen McHattie, Patrick Bauchau, Amy Locane
PRODUCTORA 	Double A Films. Distribuida por Lions Gate Films
WEB OFICIAL 	http://www.secretarythemovie.com/
PREMIOS 	2002: Sundance: Premio Especial del Jurado (por originalidad)
GÃ‰NERO 	Comedia | Comedia negra. Trabajo/empleo. Cine independiente USA
SINOPSIS 	Lee Holloway (Maggie Gyllenhaal) tiene el peor de los currÃ­culum cuando decide solicitar un empleo de secretaria en el bufete de abogados de E. Edward Grey (James Spader). Bastan con decir que acaba de salir de una instituciÃ³n psiquiÃ¡trica y que, tan sÃ³lo un dÃ­a despuÃ©s de volver a estar con su disfuncional familia de barrio perifÃ©rico, ha recaÃ­do ya en su hÃ¡bito secreto e inconfesable. Pese a que nunca en su vida ha tenido trabajo, Lee resulta finalmente contratada por el Sr. Grey, un misterioso abogado. Al principio el trabajo parece normal: mecanografiar cartas, archivar documentos y hacer el cafÃ©; pero Lee y el Sr. Grey no tardan en embarcarse en una relaciÃ³n mucho mÃ¡s estrecha e Ã­ntima; una relaciÃ³n que harÃ­a sonrojar a cualquier jefe de personal. (FILMAFFINITY)

CRÃTICAS 	----------------------------------------
Aclamada cinta de cine independiente. Aunque acaba de salir de una instituciÃ³n mental, una joven consigue un puesto de trabajo como secretaria a las Ã³rdenes de un misterioso abogado... con el que se embarcarÃ¡ en una relaciÃ³n personal mÃ¡s allÃ¡ de la puramente laboral. Ganadora, entre otros, del Premio Especial del Jurado en el prestigioso Festival de Cine Independiente de Sundance, con menciÃ³n especÃ­fica a su originalidad, una Ã¡cida comedia de humor negro -la leyenda que acompaÃ±a al poster reza: "asume tu posiciÃ³n"- con tintes erÃ³ticos que obtuvo muy buenas crÃ­ticas en Estados Unidos. (FILMAFFINITY)
----------------------------------------
"Secretaria, tan valiente como imperfecta, tan desconcertante como tediosa, se queda a medio camino entre la provocaciÃ³n y el vacÃ­o, quizÃ¡ por falta de contenido mÃ¡s allÃ¡ de su premisa." (Javier OcaÃ±a: Diario El PaÃ­s)
---------------------------------------