TÃTULO ORIGINAL 	2001: A Space Odyssey
AÃ‘O 	
1968 	
DURACIÃ“N 	
139 min. 	  Trailers/VÃ­deos
PAÃS 	
[Estados Unidos] 	  SecciÃ³n visual
DIRECTOR 	Stanley Kubrick
GUIÃ“N 	Stanley Kubrick & Arthur C. Clarke (Novela corta: Arthur C. Clarke)
MÃšSICA 	Richard Strauss, Johann Strauss
FOTOGRAFÃA 	Geoffrey Unsworth
REPARTO 	Keir Dullea, Gary Lockwood, William Sylvester, Daniel Richter, Douglas Rain (HAL 9000 voice), Laonard Rossiter, Margaret Tyzack, Robert Beatty, Sean Sullivan, Frank Miller, Penny Brahms, Alan Gilfford, Vivian Kubrick
PRODUCTORA 	MGM
PREMIOS 	1968: Oscar: Mejores efectos visuales. 4 nominaciones: director, guiÃ³n y direcciÃ³n artÃ­stica
GÃ‰NERO 	Ciencia ficciÃ³n | Aventura espacial. PelÃ­cula de culto
SINOPSIS 	La pelÃ­cula de ciencia-ficciÃ³n por excelencia de la historia del cine narra los diversos periodos de la historia de la humanidad no sÃ³lo del pasado, sino tambiÃ©n del futuro. Hace millones de aÃ±os, antes de la apariciÃ³n del "homo sapiens", unos primates descubren un monolito que los conduce a un estadio de inteligencia superior. Millones de aÃ±os despuÃ©s, otro monolito, enterrado en una luna, despierta el interÃ©s de los cientÃ­ficos. Por Ãºltimo, durante una misiÃ³n de la NASA, HAL 9000, una mÃ¡quina dotada de inteligencia artificial, se encarga de controlar todos los sistemas de una nave espacial tripulada. (FILMAFFINITY)

CRÃTICAS 	----------------------------------------
"La cinta mÃ¡s polÃ©mica, magnÃ©tica y genial de Kubrick (...) La elipsis del hueso-espacio, el monolito y el enmudecimiento de Hal forman ya parte de la iconografÃ­a del siglo" (Luis MartÃ­nez: Diario El PaÃ­s)
----------------------------------------
"Maravillosa obra, sin duda toda una revoluciÃ³n en su Ã©poca" (Fernando Morales: Diario El PaÃ­s)
----------------------------------------