HabitaciÃ³n en Roma
TÃTULO ORIGINAL 	HabitaciÃ³n en Roma (Room in Rome)
AÃ‘O 	
2010 	
DURACIÃ“N 	
109 min. 	 
PAÃS 	
[EspaÃ±a] 	  SecciÃ³n visual
DIRECTOR 	Julio Medem
GUIÃ“N 	Julio Medem (Idea: Julio Rojas)
MÃšSICA 	Jocelyn Pook, Russian Red
FOTOGRAFÃA 	Ãlex CatalÃ¡n
REPARTO 	Elena Anaya, Natasha Yarovenko, Enrico Lo Verso, Najwa Nimri
PRODUCTORA 	Morena Films / Alicia Produce
WEB OFICIAL 	http://www.juliomedem.org/habitacionenroma
PREMIOS 	2010: Premios Goya: 4 nominaciones: actriz (Anaya), actriz sec. (Yarovenko), guiÃ³n y canciÃ³n
GÃ‰NERO 	Drama. Romance | ErÃ³tico. Homosexualidad. Remake

SINOPSIS 	Verano de 2008. Se inspira en el film 'En la cama', del chileno MatÃ­as Bize. En un hotel del centro de Roma se conocen una rusa y una espaÃ±ola. Al dÃ­a siguiente Alba volverÃ¡ a EspaÃ±a y Natasha, a Rusia. En la habitaciÃ³n del hotel se respira una atmÃ³sfera cargada de erotismo y sensualidad. Entre ellas nace un sentimiento nuevo que ambas aceptan. Durante doce horas, las dos mujeres se confÃ­an sus vidas, hablan de sus compromisos y del amor sincero por sus respectivas parejas. (FILMAFFINITY)

CRÃTICAS 	----------------------------------------
"Medem va un paso mÃ¡s allÃ¡ en su bÃºsqueda de un mundo propio (...) una autÃ©ntica historia de amor que dejarÃ¡ su huella.