BODYWORK.2004.DVDr.Svenska-Mr_KeFF

En dvd fÃ¶r den ultimata trÃ¤ningen.


Ã…rtal: 2004
Speltid: 140 min
Genre: Samlingar
Extra info: UtgÃ¥tt! GÃ¥r ej lÃ¤ngre att kÃ¶pa.


-------------------------------------------------------------------
4 olika inspelade pass med instruktÃ¶rer. Core, Body, Aerobics och Stretch Express. Till varje pass har vi Ã¤ven spelat in separata instruktioner hur man gÃ¶r alla Ã¶vningar. Givetvis har vi till DVDn helt ny mixad musik i samma stil som pÃ¥ tidigare Bodywork cd-skivor. 



InnehÃ¥ll:

*CORE EXPRESS: I core bygger vi upp stabilitet & styrka, ger effektiv, tuff och rolig trÃ¤ning fÃ¶r rygg och mage

Jumpin' - Liberty X
No letting go - Wayne Wonder
Ooops up - SNAP (featuring NG3)
Break free - Lindos and Moth (featuring Inaya Day)

Baby be mine - Dexter
Papi chulo - Lorna
Power of bhangra - SNAP vs Motivo
Come home - Lil Devious

*AEROBICS EXPRESS: Styrka smidighet och kondition

We can do it - September
Time - Therese
Pure devotion - Freeloader
Love me right (oh Sheila) - Angel City (featuring Lara McAllen)

Self control - De-Tech
Beautiful smile - DJ Sammy
Surrender - Lasgo
The weekend - Scooter
I just can't help it - The Attic
Libre - Mambana

*BODY EXPRESS: Tuff kondition & styrketrÃ¤ning. Vi anvÃ¤nder oss av vÃ¥ran egen kroppsvikt

Can you feel the same way too - Da Buzz

Can't get enough of you - Jill Johnson
List of lovers - Antique
Let the sunshine in - Milk And Sugar
I'll be gone - Hofstone
My love is always - Safron Hill
Music and you - Room 5
Be my baby - Physics

*STRETCH EXPRESS: HÃ¤r trÃ¤nar vi balans & smigighet, ger ny kraft Ã¥t trÃ¶tta muskler.

Rapture - Iio
Coast - DY
It's love (tripping) - Goldtrix presents Andrea Brown

What a day - Coco & Stonebridge
Homeless - Novaspace


---------------------------------------------------------------

Flera uppladdningar frÃ¥n mej ser ni hÃ¤r:
 
http://thepiratebay.org/user/Sir_TankaLot


Speciella hÃ¤lsningar till: spyro, Scratzz, SPICEFREAK, anoXmous, CrilleKex, martin_edguy, Haggebulle.



BesÃ¶k *--| TankaNer . com |--* fÃ¶r mer filmer och serier!


SEEDA EFTER ER..