TÃTULO ORIGINAL 	Who's Afraid of Virginia Woolf?
AÃ‘O 	
1966 	
DURACIÃ“N 	
129 min. 	  Trailers/VÃ­deos
PAÃS 	
[Estados Unidos] 	  SecciÃ³n visual
DIRECTOR 	Mike Nichols
GUIÃ“N 	Ernest Lehman (Teatro: Edward Albee)
MÃšSICA 	Alex North
FOTOGRAFÃA 	Haskell Wexler (B&W)
REPARTO 	Elizabeth Taylor, Richard Burton, Sandy Dennis, George Segal
PRODUCTORA 	Warner Bros. Pictures
PREMIOS 	1966: 5 Oscars: Actriz (Taylor), actriz sec. (Dennis), fotografÃ­a, direc. artÃ­st. B/N, vestuario
1966: BAFTA. Mejor pelÃ­cula
GÃ‰NERO 	Drama
SINOPSIS 	George y Martha son un matrimonio que se profesa un odio salvaje. Ambos tienen personalidades autodestructivas, conocen perfectamente las debilidades del otro y saben cÃ³mo exasperarlo. George es un profesor de historia alcohÃ³lico. Martha, la hija del director de la universidad donde George da clases, es una mujer frustrada y vulnerable. Un sÃ¡bado por la noche, despuÃ©s de una fiesta, invitan a su casa a un nuevo profesor y a su esposa. La presencia de esta pareja no evita que Martha y George se humillen y maltraten como de costumbre. A travÃ©s de este cruel juego sale a relucir la verdad tanto sobre los anfitriones como sobre los invitados. (FILMAFFINITY)

CRÃTICAS 	----------------------------------------
"Despiadada pieza teatral de un peso pesado de la dramaturgia USA (...) Una de las mÃ¡s apasionadas y destructivas parejas del cine de los aÃ±os 70" (Omar Khan: Diario El PaÃ­s)
----------------------------------------
"Miserias, fustraciones y deseos de dos parejas de la aparentemente mÃ¡s respetable burguesÃ­a con un vocabulario nunca escuchado. Interesante" (Francisco Marinero: Diario El Mundo)
----------------------------------------