TÃTULO ORIGINAL 	The Duellists
AÃ‘O 	
1977 	
DURACIÃ“N 	
101 min. 	  Trailers/VÃ­deos
PAÃS 	
[Reino Unido] 	  SecciÃ³n visual
DIRECTOR 	Ridley Scott
GUIÃ“N 	Gerald Vaughan-Hughes (Novela: Joseph Conrad)
MÃšSICA 	Howard Blake
FOTOGRAFÃA 	Frank Tidy
REPARTO 	Keith Carradine, Harvey Keitel, Edward Fox, Albert Finney, Cristina Raines, Robert Stephens, Tom Conti, Diana Quick, John McEnery
PRODUCTORA 	Paramount / Enigma Productions. Productor: David Puttnam
PREMIOS 	1977: Cannes: Mejor Ã“pera Prima
GÃ‰NERO 	Drama | Drama de Ã©poca. Siglo XIX. Guerras NapoleÃ³nicas. Capa y espada
SINOPSIS 	Guerras napoleÃ³nicas (principios del XIX). El teniente de hÃºsares del ejÃ©rcito napoleÃ³nico Armand Dhubert recibe la orden de arrestar al teniente Ferand por haber participado en un duelo. Ferand, encolerizado, se enfrenta con Dhubert, lo que provocarÃ¡ un nuevo duelo, esta vez entre ellos dos. (FILMAFFINITY)

CRÃTICAS 	----------------------------------------
En la Francia de 1800, dos oficiales del ejÃ©rcito de NapoleÃ³n se enfrentan a un duelo eterno que marcarÃ¡ sus vidas en esta intensa, absorbente y magistral "Ã³pera prima". Pocos directores de la historia del cine comenzaron su carrera con una obra tan singular, estilizada y arrebatadora. (Pablo Kurt: FILMAFFINITY)
----------------------------------------
"Cautivador ejercicio de estilo alimentado por unas escenas a espada pelada de las que devuelven al sistema nervioso el destilado sabor de la adrenalina" (Luis MartÃ­nez: Diario El PaÃ­s) 