TÃTULO ORIGINAL 	Oldeuboi - Oldboy
AÃ‘O 	
2003 	
DURACIÃ“N 	
120 min. 	  Trailers/VÃ­deos
PAÃS 	
[Corea del Sur] 	  SecciÃ³n visual
DIRECTOR 	Park Chan-wook
GUIÃ“N 	Park Chan-wook, Hwang Jo-yoon, Im Joon-hyung (CÃ³mic: Nobuaki Minegishi)
MÃšSICA 	Cho Young-wuk
FOTOGRAFÃA 	Chung Chung-hoon
REPARTO 	Choi Min-sik, Yu Ji-tae, Kang Hye-jeong, Ji Dae-han, Oh Dal-su, Kim Byeong-ok, Lee Seung-Shin, Yun Jin-seo
PRODUCTORA 	Show East Co. Ltd
PREMIOS 	2004: Festival de Cannes: Gran Premio del Jurado
2004: Festival de Sitges: Mejor PelÃ­cula
GÃ‰NERO 	Thriller. Intriga | Manga. PelÃ­cula de culto
SINOPSIS 	Min-sik Choi es un hombre de negocios coreano que un dÃ­a es secuestrado y confinado durante aÃ±os en una celda en la que sÃ³lo hay una televisiÃ³n. Y, sin embargo, ignora por quÃ© razÃ³n estÃ¡ allÃ­... Es la segunda parte de la "trilogÃ­a de la venganza" de Chan-wook Park. (FILMAFFINITY)

CRÃTICAS 	----------------------------------------
"Una de esas narraciones en las que parece que todo el cine es posible, que nada se hubiera inventado aÃºn (...) narrada sin ninguna atadura, sin pagar peaje a los cÃ³digos del gÃ©nero (...) Brutal desenlace (... ) Un filme excepcional en toda la acepciÃ³n de la palabra" (M. Torreiro: Diario El PaÃ­s)
----------------------------------------
"Dura, retorcida y brutal historia (...) Uno lo sigue a trompicones, sin acabar de pillarlo por completo, pero en un cierto estado hipnÃ³tico en el que pesa tanto la curiosidad como el temor a lo que pueda suceder en cualquier momento. (...) un final indescriptible. (...) PuntuaciÃ³n: *** (sobre 5)." (E. RodrÃ­guez Marchante: Diario ABC) 