89ers - Go Go Go Go! (Radio Edit)

Abel Almena Pres Millenium - Candy Girl (Radio Edit)
Akon - One More Time

Britney Spears - Hold It Against Me
Britney Spears - Hold It Against Me (Private Radio Tk Mix 2011)
Britney Spears Ft. Flo Rida - Hold It Against Me (Remix)

Chris Brown Feat. Pitbull - International Love
City Of Lights - Mirage (Radio Edit)

Dj Layla Feat. Dee-Dee - Superman Ikodia (Radio Edit)
Dj Sequence - I Need You (Radio Edit)
Dj Slider - Dancin In The Rain (Radio Edit)

Ellie White - Love Again (Radio Edit)
Enrique Feat. Ludacris - Tonight (I'm Lovin' You) (Wideboys Club Mix)
Enrique Feat. Ludacris - Tonight (I'm Lovin' You) (Wideboys Radio Edit)
E-Type - Back 2 Life (Radio Edit)

Ian Davecore - Love Story

Jasper Forks - Alone (Radio Edit)
Jay Sean feat. Pitbull - Do It For U
Jennifer Lopez feat. Pitbull - On The Floor (Final Version)
Jennifer Lopez feat. Pitbull - On The Floor (Radio Edit)

Katy Perry - Dressin Up
Kesha - Princess Kesha

Lady Gaga - Scheibe (Born This Way Remix)
Lolita vs. Flo Rida feat. Akon - Who Dat Joli Garcon
Loona vs. Movetown - El Cucaracho (Casspar Cabrio Edit)
Lora - No More Tears (Radio Edit)

Medina - Vi To (C'cik Radio Remix)
Morandi - Midnight Train (Radio Edit)

Nicole Scherzinger - Cold

Pitbull Ft. Akon - Mr. Right Now

R.I.O - Like I Love You (Extended Mix)
R.I.O. - Like I Love You (Money-G Remix)
Rawanne - Missing you
Reckless - The End (Bodybangers Radio Edit)
Remady - Save Your Heart (feat. Manu-L)(Radio Edit)
Remady feat Manu-L - Save Your Heart (Extended Mix)
Residence Deejays Frissco - Echo
Rihanna ft. J Cole - S&M (Remix)
Roxette - She's Got Nothing On (But The Radio)

Siberian Heat - Sorry (Maxi 99 Mix 2011)

The Crazy Frogs - The Ding Dong Song
Tom Boxer & Catherine Cassidy - You (Radio Edit)

Usher Featuring Pitbull - DJ Got Us Fallin In Love (Almighty Radio Mix)