
Artist...............: Various Artists
Album................: Now That's What I Call Music! 80 [Double CD]
Genre................: Pop
Source...............: CD
Year.................: 2011
Ripper...............: EAC (Secure mode) / LAME 3.92  
Codec................: FhG
Version..............: MPEG 1 Layer III
Quality..............: Insane, (avg. bitrate: 320kbps)


 



     ---------------------------------------------------------------------
                            Tracklisting - CD 1
     ---------------------------------------------------------------------

   1. Maroon 5 - Moves Like Jagger (Feat. Christina Aguilera)
   2. Rihanna - We Found Love (Album Version)
   3. One Direction - What Makes You Beautiful                
   4. Bruno Mars - Marry You                                  
   5. JLS - Take A Chance On Me                           
   6. Christina Perri - Jar Of Hearts                    
   7. Kelly Clarkson - Mr. Know It All                        
   8. Olly Murs - Heart Skips A Beat (Feat. Rizzle Kicks)    
   9. The Wanted - Lightning                                  
  10. Pixie Lott - All About Tonight                        
  11. The Saturdays - All Fired Up                          
  12. Lady Gaga - The Edge Of Glory                          
  13. Will Young - Jealousy (Radio Edit)                   
  14. James Morrison - I Won't Let You Go                   
  15. Ed Sheeran - You Need Me, I Don't Need You            
  16. Damien Rice - Cannonball                            
  17. Lana Del Rey - Video Games                              
  18. Charlene Soraia - Wherever You Will Go                  
  19. The Goo Goo Dolls - Iris                               
  20. Matt Cardle - Run For Your Life                        
  21. Westlife - Lighthouse                                




    ---------------------------------------------------------------------
                            Tracklisting - CD 2
    ---------------------------------------------------------------------

   1. Adele - Set Fire To The Rain                            
   2. Professor Green -                                      
   3. Gym Class Heroes - Stereo Hearts (Feat. Adam Levine)    
   4. Labrinth - Earthquake (Feat. Tinie Tempah)            
   5. Jason Derulo - It Girl                              
   6. Dappy - No Regrets (Radio Edit)                       
   7. David Guetta - Without You (Feat. Usher)             
   8. Calvin Harris - Feel So Close (Radio Edit)             
   9. Leona Lewis - Collide (Feat. Avicii)                  
  10. Example - Stay Awake                                    
  11. Sean Kingston - Party All Night (Sleep All Day)       
  12. Tinchy Stryder - Off The Record (Radio Edit)
  13. Sak Noel - Loca People (UK Radio Edit)                  
  14. Rizzle Kicks - Down With The Trumpets                
  15. Cher Lloyd - With Ur Love (Feat. Mike Posner)        
  16. Jessie J - Who's Laughing Now                       
  17. Rihanna - Cheers (Drink To That)                   
  18. Sean Paul - Got 2 Luv U (Feat. Alexis Jordan)          
  19. Emeli Sande - Heaven                                   
  20. Maverick Sabre - I Need                                
  21. Wretch 32 - Don't Go (Radio Edit) [Feat. Josh Kumra]    
  22. The Collective - Teardrop (Feat. Labrinth, Tulisa Contostavlos, Chipmunk, Dot Rotten, Ed Sheeran, Ms. Dynamite, Mz Bratt, Rizzle Kicks, Tinchy Stryder & Wretch 32)...

ENJOY & PLEASE SEED 

RIPPED BY Stumpie1971
		