A great deal of house music presented to you by Jeppelepsi.



I get tracks each day, mostly new stuff but sometimes oldies.
I will update weekly with new hot tracks so always download the latest torrent!
There will be new tracks in each torrent and instead of adding a new torrent with ALL my music over and over again, I decided to update only the new stuff. I will make a rar file and name them with "Husbehov Edit #X" (X=The higher number, the latest version) so that you who already downloaded an earlier version of my Husbehov will be able to know which torrent you will download next time.

All songs are 320 kbps but I use Audacity to cut songs where I think they should start. That's why in the description it says 128 kbps. The quality doesn't get worse, it only says so in the description.



This edit contains following HOT tracks:
Alex Lamb - It's A Trap (Original Mix)
Benny Benassi - Cinema (Original Mix) (Feat. Gary Go)
Bloc Party - Blue Light (Sulocki's Down To Earth Remix)
Calvin Harris - Flashback (Fareoh & Jarleen Morning Remix)
Chris Lake - Running Out (Jordy Lishious' Dope & Dirt Remix) (& Marco Lys)
D. Ramirez - Keep Us Together (Original Mix) (& Mara Feat. Steve Edwards)
Daft Punk - Derezzed (Original Mix)
Dany Coast - Swede Harmony (Original Mix) (Feat. Christina Skaar)
Deadmau5 - Raise Your Weapon (Justin Michael Rework)
Duck Sauce - Barbra Streisand (Original Mix)
Eric Prydz - Niton (The Reason) (Treasure Fingers Remix)
Example - Two Lives (Kris Menace Remix)
Frederic Van Hooft - Tarantella (Original Mix)
Freemasons - Believer (TV Rock Vocal Mix) (Feat. Wynter Gordon)
Hardwell - Asteroid (Original Mix) (& Franky Rizardo)
Huggy - Soul Roots (Antranig Remix) (& Dean Newton)
Hype Jonas - Never Give Up (Deniz Koyu Remix) (& Alex Sayz Feat. Mario Vasquez)
Jan Sulocki - Breeze (Original Mix)
Jan Sulocki - Dots (Original Mix)
Jan Sulocki - The L Word (Original Mix)
Jerry Rekonius - Collab (Original Mix) (& Daniel Pereaux)
John DahlbÃ¤ck - Kairo (Original Mix)
John De Sohn - Find Your Way (Original Mix) (Feat. Miss Selia)
Kaskade - All That You Give (Kaskade's Big Room Mix) (Feat. Mindy Gledhill)
Michael Cassette - Ghost In The Machine (Original Mix)
Michael Parsberg - Summertime (Original Mix) (& Flipside)
Michael Woods - No Access (Original Mix)
Mick Kastenholt - Check This Out (Original Mix) (& Andrew Dee)
Mikael Weermets - Vega (Dreams) (Club Mix) (& Audible Feat. Hila)
Moguai - We Want Your Soul (Sebjak Remix)
N.E.R.D - Hot 'N' Fun (Starsmith Remix)
Nadia Ali - At The End (Hardwell Extended Mix)
Penguin Prison - Golden Train (Kim Fai Remix)
Pleasurekraft - Tarantula (Team Wing Bootleg)
Sebjak - Shock (Original Mix)
Starsmith - Give Me A Break (Starsmith Remix)
Steve Angello - Knas & Insomnia (East & Young Bootleg) (& Faithless)Steve Angello - Valodja (DJ Whitlock Remix) (& AN21)
Switchfoot - Your Love Is A Song (Sven Kirchhof's Footstep Remix)
Tensnake - Coma Cat (Mark Knight Remix)
Tommy Trash - All My Friends (MyBack Remix) (Feat. Mr Wilson)
Tristan Garner - Fallin' (Original Mix) (Feat. Polina)






Stay tuned.



Enjoy