AÃ±os 90-El mejor album de los 90s

Cd 1

Nicky French - Total Eclipse of the Heart
Dhanny - Yo quiero respirar
Corona - Rhythm of the Night
Double You - Please Don't Go
Ice MC - Think about the way
Gala - Freed from Desiree
Netzwek - Memories
Jamie D - Don't be shy
Ken Lazlo - Whatever love
Double Dare - We belong
Caught in the Act - Love is everywhere
D-Javu - In the Evening

Cd 2

Newton - Skyhigh
Tatjana - Santa Maria
John Wesley - Lover Why
Alexia - The Summer is Crazy
Due - Under the same sun
Digilove - Let the night take a blame
Black & White - Do you know
JK - You & I
Lalene - The Best
Fourteen 14 - Goodbye
Co.Ro feat. Lyen - Runaway
Patty Dart - Frederick


Cd 3

Axel Force - Always
Dream Project - Take a change
Diana's - All I need is love
Rochelle - Think Twice
Bandido - I drove allnight
Tranx Mission - Time to Wonder
Co.Ro - Because the Night
Sechi feat. Taleesa - A brigther day
Emotional G - Tofee
Co.Ro feat. Taleesa - 4 your love
Gem - I Feel you Tonight
Jerry Daley - Gold
Robin - Juliet
