TÃTULO ORIGINAL 	Stagecoach
AÃ‘O 	
1939 	
DURACIÃ“N 	
99 min. 	  Trailers/VÃ­deos
PAÃS 	
[Estados Unidos] 	 
DIRECTOR 	John Ford
GUIÃ“N 	Dudley Nichols (Historia: Ernest Haycox)
MÃšSICA 	Varios (canciones populares americanas siglo XIX)
FOTOGRAFÃA 	Bert Glennon (B&W)
REPARTO 	John Wayne, Claire Trevor, Thomas Mitchell, Andy Devine, George Bancroft, Donald Meek, Louise Platt, John Carradine, Berton Churchill
PRODUCTORA 	United Artists
PREMIOS 	1939: 2 Oscars: Mejor Actor de Reparto (Thomas Mitchell), bso (adaptada). 7 nominaciones
GÃ‰NERO 	Western
SINOPSIS 	Personajes muy variopintos emprenden un largo, duro y peligroso viaje en diligencia. Entre ellos, un fuera de la ley en busca de venganza, una prostituta a la que han echado del pueblo, un jugador, un mÃ©dico, la mujer embarazada de un militar, un sheriff. Las relaciones entre ellos serÃ¡n difÃ­ciles y tensas. AdemÃ¡s, durante el viaje, tendrÃ¡n que afrontar el ataque de una partida de indios apaches. (FILMAFFINITY)

CRÃTICAS 	----------------------------------------
Aunque parezca extraÃ±o, en 1939 el gÃ©nero del western estaba bastante infravalorado y declarado "pasado de moda". Gracias a esta pelÃ­cula, el maestro Ford consiguiÃ³ resucitarlo y ponerlo de nuevo en las mÃ¡s altas cotas de la calidad artÃ­stica y la aceptaciÃ³n popular. AsÃ­, en "Stagecoach" no sÃ³lo comienza un Ã©pico viaje de un grupo de personas por el Monument Valley. TambiÃ©n la mÃ¡s gloriosa etapa de un gÃ©nero que, reciÃ©n reinventado, avanzarÃ¡ al galope por el valle del sÃ©ptimo arte bajo las riendas del mejor director que jamÃ¡s ha existido y de un tal John Wayne... ambos directos a la leyenda. (Pablo Kurt: FILMAFFINITY)
----------------------------------------
"La esencia mÃ¡s pura del Far West late en esta obra (...) da carta de naturaleza al mito icÃ³nico de John Wayne, cuyo personaje se mueve entre un inolvidable plantel de secundarios" (Miguel Ãngel Palomo: Diario El PaÃ­s)
----------------------------------------