TÃTULO ORIGINAL 	The Boston Strangler
AÃ‘O 	
1968 	
DURACIÃ“N 	
120 min. 	  Trailers/VÃ­deos
PAÃS 	
[Estados Unidos] 	  SecciÃ³n visual
DIRECTOR 	Richard Fleischer
GUIÃ“N 	Edward Anhalt
MÃšSICA 	Lionel Newman
FOTOGRAFÃA 	Richard H. Kline
REPARTO 	Tony Curtis, Henry Fonda, George Kennedy, Mike Kellin, Hurd Hatfield, Murray Hamilton, Sally Kellerman, Jeff Corey
PRODUCTORA 	20th Century Fox
GÃ‰NERO 	Intriga | Basado en hechos reales. Asesinos en serie
SINOPSIS 	Basado en sucesos reales. En Boston, entre 1962 y 1964, trece mujeres fueron brutalmente estranguladas por Robert de Salvo, un fontanero felizmente casado y con una vida aparentemente normal. (FILMAFFINITY)

CRÃTICAS 	----------------------------------------
Curiosa reconstrucciÃ³n de la vida del famoso asesino que aterrorizÃ³ la ciudad americana de Boston a comienzos de los sesenta. EstÃ©tica setentera y esplÃ©ndido reparto para un filme que se engrandece ante la impresionante primera apariciÃ³n, de mirada brutal, de un Tony Curtis que corta la respiraciÃ³n. (Pablo Kurt: FILMAFFINITY)
----------------------------------------
"NarraciÃ³n frÃ­a, cerca del documental, terriblemente efectiva. En el recuerdo, la fractura de las pantallas en pequeÃ±as ventanas y la anÃ³mala y brutal interpretaciÃ³n de Curtis" (Luis MartÃ­nez: Diario El PaÃ­s)
----------------------------------------