I have chosen to upload all files as one rar file. In that way I favour those who wants all files, rather those who just pick and choose (thus stealing upload spead).

The Most Deliquate Love Songs

Aaron Neville - Ave Maria
Art Garfunkel - Bright Eyes
Bangles - Eternal Flame
Barbra Streisand - Memory
Barry Manilow - Mandy
Berlin - Take My Breath Away
Bjorn Skifs - Hall Mitt Hjarta
Bonnie Tyler - Total Eclipse Of The Heart
Charles Aznavour - She
Chet Baker - My Funny Valentine
Chris De Burgh - The Lady In Red
Dr. Hook - Sylvia's mother
Eagles - Hotel California
Elvis Presley - Love Me Tender
Eric Clapton - Tears In Heaven
Inda Ronstadt and Aaron Neville - Don't Know Much
Jane Birkin & Serge Gainsbourg - Je Taime (Moi Non Plus)
John Denver - Annie's Song
Kate Bush & Peter Gabriel - Don't give up
Kool & The Gang - Cherish
Led Zeppelin - Stairway To Heaven
Marie Fredriksson - Sa Skimrande Var Aldrig Havet
Marvin Gaye - Sexual Healing
Michael Jackson - Ben
Nilsson - Without You
Olivia Newton-John - Hopelessly Devoted To You
Randy Crawford - Almaz
Rihanna - Russian Roulette
Rod Stewart - Sailing
Rolling Stones - Angie
Scorpions - Still Loving You
Simon & Garfunkel - Bridge Over Troubled Water
Sinead O'connor - Nothing Compares 2 U
Terence Trent D`Arby - Sign Your Name
Tom Jones - (It Looks Like) I'll Never Fall In Love Again
Toni Braxton - Unbreak My Heart

Enjoy!