SeleÃ§Ã£o Juninho PagodÃ£o


Abertura Especial - WwW.JuNinHoPaGoDaO.NeT.mp3

A Bronkka - Mamboleio - WwW.JuNinHoPaGoDaO.NeT.mp3


Oz Bambaz - Botadinha - WwW.JuNinHoPaGoDaO.NeT.mp3


Os BarÃµes - Rabo De Cavalo  - WwW.JuNinHoPaGoDaO.NeT.mp3

Guettho Ã© Guettho - Faz Gostoso - WwW.JuNinHoPaGoDaO.NeT.mp3

A Bronkka - Dedo Calibrado - WwW.JuNinHoPaGoDaO.NeT.mp3

ParangolÃ© - Madeira de Lei - WwW.JuNinHoPaGoDaO.NeT.mp3

Rapina - VocÃª Ã© Meu Mundo - WwW.JuNinHoPaGoDaO.NeT.mp3

Guig Ghetto - SwingÃ£o - WwW.JuNinHoPaGoDaO.NeT.mp3

Edcity - PamPamRanRamPamPam - WwW.JuNinHoPaGoDaO.NeT.mp3

O Troco - JoÃ£o SorrisÃ£o - WwW.JuNinHoPaGoDaO.NeT.mp3

FantasmÃ£o - Pegada de Africano - WwW.JuNinHoPaGoDaO.NeT.mp3

Black Style - Piu, Piu - WwW.JuNinHoPaGoDaO.NeT.mp3

Leva Noiz - Bolimbolacho - WwW.JuNinHoPaGoDaO.NeT.mp3

Marreta Ã© Massa - Mexer Bum Bum - WwW.JuNinHoPaGoDaO.NeT.mp3

Marreta You Planeta - Rolou Sentimento - WwW.JuNinHoPaGoDaO.NeT.mp3

Raghatoni - Cutuki - WwW.JuNinHoPaGoDaO.NeT.mp3

Saiddy Bamba - Beijou Melou - WwW.JuNinHoPaGoDaO.NeT.mp3

A Formulla - Cachorro Quente - WwW.JuNinHoPaGoDaO.NeT.mp3

Oz Bambaz - Baixaria - WwW.JuNinHoPaGoDaO.NeT.mp3

O Rodo - Colinho 2 - WwW.JuNinHoPaGoDaO.NeT.mp3

Psirico - Bate Cabelo - WwW.JuNinHoPaGoDaO.NeT.mp3

SelaKuatro - Rebolado do Sela - WwW.JuNinHoPaGoDaO.NeT.mp3

Assombra - Chora Ainda Baba - WwW.JuNinHoPaGoDaO.NeT.mp3

Bam Bam - Desenho Animado - WwW.JuNinHoPaGoDaO.NeT.mp3

KolÃ© I Pan - DanÃ§a da Bicicleta - WwW.JuNinHoPaGoDaO.NeT.mp3

Harmonia Do Samba - Sou do Pagode - WwW.JuNinHoPaGoDaO.NeT.mp3

CaldeirÃ£o - E Ai Qual Vai Ser - WwW.JuNinHoPaGoDaO.NeT.mp3

Nosso Som - Ah Como eu TÃ´ Bandida - WwW.JuNinHoPaGoDaO.NeT.mp3

New Hit - Pick Up - WwW.JuNinHoPaGoDaO.NeT.mp3

Ã‰ Xeke - Homem Aranha - WwW.JuNinHoPaGoDaO.NeT.mp3

Pagodart - Senta que Ã© de Menta - WwW.JuNinHoPaGoDaO.NeT.mp3
