TÃTULO ORIGINAL 	Lolita
AÃ‘O 	
1962 	
DURACIÃ“N 	
152 min. 	  Trailers/VÃ­deos
PAÃS 	
[Reino Unido] 	 
DIRECTOR 	Stanley Kubrick
GUIÃ“N 	Vladimir Nabokov (Novela: Vladimir Nabokov)
MÃšSICA 	Nelson Riddle
FOTOGRAFÃA 	Oswald Morris (B&W)
REPARTO 	James Mason, Sue Lyon, Shelley Winters, Peter Sellers, Marianne Stone, Diana Decker, Jerry Stovin, Gary Cockrell, Suzanne Gibs, Roberta Shore, Cec Linder, Lois Maxwell, William Greene, Eric Lane, Shirley Douglas, Roland Brand, Colin Maitland, Irvin Allen
PRODUCTORA 	CoproducciÃ³n USA-Suiza; MGM presenta una producciÃ³n Seven Arts / Anya Productions / Transworld
PREMIOS 	1962: Nominada al Oscar: Mejor guiÃ³n adaptado
GÃ‰NERO 	Drama. Romance
SINOPSIS 	Humbert Humbert, un profesor cuarentÃ³n, acaba de instalarse en Ramsdale, New Hampshire. AllÃ­ se enamora perdidamente de una niÃ±a de once aÃ±os, tanto que concibe un plan maestro: se casarÃ¡ con su madre, Charlotte Haze, para poder estar siempre cerca del objeto de sus afectos: la alegre adolescente, la irresistible nÃ­nfula de nombre encantador, lÃ­rico y melodioso: Lolita. (FILMAFFINITY)

CRÃTICAS 	----------------------------------------
La maravillosa novela de Nabokov tuvo una excelente adaptaciÃ³n cinematogrÃ¡fica a cargo de otro maestro singular. AsÃ­, Kubrick se atreve con la turbulenta relaciÃ³n de un padrastro y su hija adolescente, creando una pelÃ­cula bella, sugerente y desgarradora sobre la perversa obsesiÃ³n de la naturaleza humana. La polÃ©mica ya estaba servida de antemano, pero el arte acallÃ³ las voces religiosas que se levantaron contra su exhibiciÃ³n. Muy buena. (Pablo Kurt: FILMAFFINITY)
----------------------------------------
"Gran cine e inteligente, vigoroso y arriesgado ejercicio de puesta en pantalla que nos abre al Kubrick en plena posesiÃ³n de su talento" (Ãngel Fdez. Santos: Diario El PaÃ­s)
-----------------------------------