TÃTULO ORIGINAL 	Blow-Up (Blowup)
AÃ‘O 	
1966 	
DURACIÃ“N 	
108 min. 	  Trailers/VÃ­deos
PAÃS 	
[Reino Unido] 	  SecciÃ³n visual
DIRECTOR 	Michelangelo Antonioni
GUIÃ“N 	Tonino Guerra & Michelangelo Antonioni (Cuento: Julio CortÃ¡zar)
MÃšSICA 	Herbert Hancock (AKA Herbie Hancock)
FOTOGRAFÃA 	Carlo Di Palma
REPARTO 	David Hemmings, Vanessa Redgrave, Sarah Miles, Peter Bowles, Jane Birkin, Gillian Hills, Verushka
PRODUCTORA 	Bridge Films. Distribuida por MGM
PREMIOS 	1966: Cannes: Palma de Oro (mejor pelÃ­cula)
1966: Oscar: 2 nominaciones: Mejor director, guiÃ³n original
1966: Globos de Oro: Nominada a la mejor pelÃ­cula extranjera de habla inglesa
1967: BAFTA: 3 nominaciones: mejor pelÃ­cula britÃ¡nica, fotografÃ­a, direcciÃ³n artÃ­stica
GÃ‰NERO 	Intriga. Drama. Thriller
SINOPSIS 	AdaptaciÃ³n de un cuento de Julio CortÃ¡zar que narra la historia de un fotÃ³grafo que, tras realizar unas tomas en un parque londinense, descubre al revelarlas una forma irreconocible que resulta ser un cadÃ¡ver. Fue premiada en el Festival de Cannes con la Palma de Oro. (FILMAFFINITY)

CRÃTICAS 	----------------------------------------
Seguramente conocerÃ¡n Vds. esa leyenda urbana que afirma que una vez un tipo vio una pelÃ­cula de Antonioni hasta el final. Evidentemente es un bulo, porque las pelÃ­culas del director italiano son tan densas, y los temas que tratan poseen tal gravedad, que nada -ni la luz, ni el tiempo, ni el aburrimiento- puede escapar a su fuerza de atracciÃ³n; por tanto carecen de todo principio o final, y son, consecuentemente, infinitas y eternas, como Dios o la resaca de la sangrÃ­a. Uno no ve una pelÃ­cula de Antonioni: es absorbido por ella. Una sinopsis estÃ¡ndar de Ã©sta dirÃ­a algo asÃ­ como: "Durante un verano del Swinging London de los 60, un fotÃ³grafo de modas cree haber registrado un asesinato con su cÃ¡mara. Su deseo de conocer quÃ© ocurriÃ³ en realidad le llevarÃ¡ a un viajeâ€¦", etc. Sin embargo, como no podÃ­a ser de otra forma estando basada en un cuento de CortÃ¡zar, en esta pelÃ­cula hasta la realidad es engullida por un agujero negro. De modo que, siguiendo la lÃ³gica cuÃ¡ntica, hay en ella un crimen sin vÃ­ctima, una trama sin acciÃ³n, efectos sin causa y una historia sin sentido. Por todo lo cual resulta indefectible y absolutamente hipnÃ³tica. (Daniel Andreas: FILMAFFINITY) 