TÃTULO ORIGINAL 	Frantic
AÃ‘O 	
1988 	
DURACIÃ“N 	
120 min. 	  Trailers/VÃ­deos
PAÃS 	
[Estados Unidos] 	  SecciÃ³n visual
DIRECTOR 	Roman Polanski
GUIÃ“N 	Roman Polanski & GÃ©rard Brach
MÃšSICA 	Ennio Morricone
FOTOGRAFÃA 	Witold Sobocinski
REPARTO 	Harrison Ford, Emmanuelle Seigner, Betty Buckley, John Mahoney, Alexandra Stewart, Robert Barr, David Huddleston
PRODUCTORA 	CoproducciÃ³n USA-Francia; Warner Bros. Pictures / The Mount Company
GÃ‰NERO 	Intriga. Drama
SINOPSIS 	La asistencia a una conferencia en ParÃ­s le brinda al doctor Richard Walken y a su esposa la oportunidad de revivir su luna de miel. Pero, poco despuÃ©s de instalarse en la habitaciÃ³n del hotel, su mujer desaparece misteriosamente. Completamente solo, en un paÃ­s desconocido cuyo idioma ignora, Walken emprenderÃ¡ la bÃºsqueda de su mujer. La Ãºnica pista que tiene es un nÃºmero de telÃ©fono apuntado en una caja de cerillas, y, a partir de ahÃ­, la trama se irÃ¡ complicando hasta convertirse en una autÃ©ntica pesadilla. (FILMAFFINITY)

CRÃTICAS 	----------------------------------------
Harrison Ford es un americano en ParÃ­s... pero no estÃ¡ precisamente para nÃºmeros musicales (el baile lo pone la Seigner). Su mujer ha desaparecido, y el pobre empieza una angustiosa y frenÃ©tica bÃºsqueda para encontrarla. Su mayor mÃ©rito es la credibilidad que inspira Harrison Ford -tanto el personaje como la interpretaciÃ³n-, amÃ©n de un guiÃ³n muy bien dosificado, algo fallido en su comercial final. Muy interesante. (Pablo Kurt: FILMAFFINITY)
----------------------------------------
"Entretenida y comercial pelÃ­cula" (Javier Rioyo: CinemanÃ­a)
----------------------------------------