TÃTULO ORIGINAL 	All That Jazz
AÃ‘O 	
1979 	
DURACIÃ“N 	
123 min. 	  Trailers/VÃ­deos
PAÃS 	
[Estados Unidos] 	  SecciÃ³n visual
DIRECTOR 	Bob Fosse
GUIÃ“N 	Robert Alan Aurthur & Bob Fosse
MÃšSICA 	Ralph Burns
FOTOGRAFÃA 	Giuseppe Rotunno
REPARTO 	Roy Scheider, Jessica Lange, Leland Palmer, Ann Reinking, Ben Vereen, Cliff Gorman, John Lithgow, Wallace Shawn
PRODUCTORA 	Columbia Pictures / 20th Century Fox
PREMIOS 	1979: 4 Oscars: Bso adaptada, vestuario, direcciÃ³n artÃ­stica, montaje. 9 nominaciones
1979: Festival de Cannes: Palma de Oro (ex aequo)
GÃ‰NERO 	Musical. Drama
SINOPSIS 	Un musical nada convencional que, a travÃ©s de la historia de un implacable coreÃ³grafo, retrata la dureza, el esplendor y la decadencia de las gentes del mundo del espectÃ¡culo, a quienes el triunfo les niega a veces la posibilidad de otros afectos. Una pelÃ­cula que retrata la otra cara del show, lo que ocurre entre bastidores. (FILMAFFINITY)

CRÃTICAS 	----------------------------------------
"InteresantÃ­simo musical dramÃ¡tico, totalmente imprescindible" (Fernando Morales: Diario El PaÃ­s)
----------------------------------------