THISS ALBUM IS NOT DUE FOR REALESE TILL 5TH DECEMBER , THIS TORRENT IS NOT RETAIL COPY OF THE ALBUM. ITS NEARLY THE EXACT SAME .  SORRY THERE IS 3 SONGS MISSING 1 FROM EACH DISC . 1 MISSING SONG THERE IS SAMPLE MP3 FOR THAT SONG 

IL UPLOAD RETAIL SOON!!!!


THANK YOU PLS SEEDD!!!!







Disc 1

We Found Love - Rihanna Feat. Calvin Harris
Down For Whatever - Kelly Rowland Feat. The WAV.s
Papi - Jennifer Lopez
Still Speedin' - Sway Feat. kano
Pass At Me - Timbaland Feat. Pitbull
Right There - Nicole Scherzinger Feat. 50 Cent
Headlines - Drake
My Last - Big Sean Feat. Chris Brown
Lick Ya Down - Cover Drive
Down With The Trumpets - Rizzle Kicks
Spinnin' For 2012 - Dionne Bromfield Feat. Tinchy Stryder
Go In, Go Hard - Angel Feat. Wretch 32
Cupid - Lloyd Feat. Awesome Jones!!!!
Buzzin - Mann Feat. 50 Cent
Down On Me - Jeremih Feat. 50 Cent
I'm On One - DJ Khaled Feat. Drake, Rick Ross & Lil Wayne
Ballin' - Young Jeezy Feat. Lil Wayne
99 Problems - JAY-Z
Hustle Hard - Ace Hood
Racks - YC Worldwide Feat. Future

Disc 2

Fly - Nicki Minaj Feat. Rihanna
Dedication To My Ex (Miss That) - Lloyd Feat. Andre 3000 & Lil Wayne
Try With Me - Nicole Scherzinger
Teardrop - The Collective Feat. Labrinth, Tulisa Contostavlos, Chipmunk, Dot Rotten, Ed Sheeran, Ms. Dynamite, Mz Bratt, Rizzle Kicks, Tinchy Stryder & Wretch 32
No Regrets - Dappy
When I Was A Youngster - Rizzle Kicks
Spaceship - Tinchy Stryder Feat. Dappy
Coming Home - Diddy - Dirty Money Feat. Skylar Grey
Price Tag - Jessie J
Free - Natalia Kills Feat. will.i.am
Lose Control - Keri Hilson, Nelly
Let Me Go - Maverick Sabre
Just A Dream - Nelly
How To Love - Lil Wayne
Far Away - Tyga Feat. Chris Richardson
Swim Good - Frank Ocean
Beggin - Project Alfie
Flow - Boyz II Men
Love Is - Carli Johnson Feat. Danso

Disc 3

Party Rock Anthem - LMFAO Feat. Lauren Bennett & GoonRock
Only Girl (In The World) - Rihanna
Ass On The Floor - Diddy - Dirty Money Feat. Swizz Beatz
Super Bass - Nicki Minaj
Don't Stop The Party - The Black Eyed Peas
Like A G6 - Far East Movement Feat. The Cataracs & DEV
No Beef - Afrojack Feat. Steve Aoki & Miss Palmer
Bass Down Low - DEV Feat. The Cataracs
Hitz - Chase & Status Feat. Tinie Tempah
Freak On The Dancefloor - Blackout Mode Feat. Craig David
I Want You Out (Of My House) [The Bilderberg Group Remix] - Selah Feat. Donae'o
Do It Like A Dude - Jessie J
Lay It On Me - Kelly Rowland Feat. Big Sean
Pretty Girl Rock - Keri Hilson
If We Ever Meet Again - Timbaland Feat. Katy Perry
Up Out My Face - Mariah Carey Feat. Nicki Minaj
Dirt Off Your Shoulder - JAY-Z
6 Foot 7 Foot - Lil Wayne Feat. Cory Gunz
All The Boyz - Duchess
Go-cisive - Incisive



